År;Region;Alder;Utflytting;Innflytting;Nettoflytting
2016;3801 Horten;0 år;9;12;3
2016;3801 Horten;1 år;23;22;-1
2016;3801 Horten;2 år;12;19;7
2016;3801 Horten;3 år;11;18;7
2016;3801 Horten;4 år;12;17;5
2016;3801 Horten;5 år;13;18;5
2016;3801 Horten;6 år;7;19;12
2016;3801 Horten;7 år;9;11;2
2016;3801 Horten;8 år;6;14;8
2016;3801 Horten;9 år;9;6;-3
2016;3801 Horten;10 år;13;15;2
2016;3801 Horten;11 år;8;14;6
2016;3801 Horten;12 år;15;18;3
2016;3801 Horten;13 år;9;14;5
2016;3801 Horten;14 år;12;11;-1
2016;3801 Horten;15 år;18;24;6
2016;3801 Horten;16 år;14;11;-3
2016;3801 Horten;17 år;13;11;-2
2016;3801 Horten;18 år;15;16;1
2016;3801 Horten;19 år;47;44;-3
2016;3801 Horten;20 år;55;56;1
2016;3801 Horten;21 år;66;67;1
2016;3801 Horten;22 år;78;66;-12
2016;3801 Horten;23 år;67;66;-1
2016;3801 Horten;24 år;70;64;-6
2016;3801 Horten;25 år;84;64;-20
2016;3801 Horten;26 år;70;51;-19
2016;3801 Horten;27 år;64;70;6
2016;3801 Horten;28 år;51;53;2
2016;3801 Horten;29 år;53;35;-18
2016;3801 Horten;30 år;51;44;-7
2016;3801 Horten;31 år;33;42;9
2016;3801 Horten;32 år;31;31;0
2016;3801 Horten;33 år;20;20;0
2016;3801 Horten;34 år;27;26;-1
2016;3801 Horten;35 år;22;22;0
2016;3801 Horten;36 år;21;22;1
2016;3801 Horten;37 år;26;27;1
2016;3801 Horten;38 år;15;27;12
2016;3801 Horten;39 år;19;25;6
2016;3801 Horten;40 år;20;18;-2
2016;3801 Horten;41 år;12;10;-2
2016;3801 Horten;42 år;18;21;3
2016;3801 Horten;43 år;12;21;9
2016;3801 Horten;44 år;13;10;-3
2016;3801 Horten;45 år;9;14;5
2016;3801 Horten;46 år;11;16;5
2016;3801 Horten;47 år;23;10;-13
2016;3801 Horten;48 år;14;12;-2
2016;3801 Horten;49 år;13;17;4
2016;3801 Horten;50 år;10;13;3
2016;3801 Horten;51 år;11;12;1
2016;3801 Horten;52 år;15;12;-3
2016;3801 Horten;53 år;18;11;-7
2016;3801 Horten;54 år;9;10;1
2016;3801 Horten;55 år;13;18;5
2016;3801 Horten;56 år;10;7;-3
2016;3801 Horten;57 år;13;9;-4
2016;3801 Horten;58 år;5;7;2
2016;3801 Horten;59 år;5;8;3
2016;3801 Horten;60 år;5;11;6
2016;3801 Horten;61 år;12;10;-2
2016;3801 Horten;62 år;8;4;-4
2016;3801 Horten;63 år;5;8;3
2016;3801 Horten;64 år;3;4;1
2016;3801 Horten;65 år;6;2;-4
2016;3801 Horten;66 år;4;4;0
2016;3801 Horten;67 år;5;8;3
2016;3801 Horten;68 år;13;5;-8
2016;3801 Horten;69 år;4;8;4
2016;3801 Horten;70 år;6;9;3
2016;3802 Holmestrand;0 år;5;14;9
2016;3802 Holmestrand;1 år;16;25;9
2016;3802 Holmestrand;2 år;11;26;15
2016;3802 Holmestrand;3 år;12;24;12
2016;3802 Holmestrand;4 år;15;24;9
2016;3802 Holmestrand;5 år;14;20;6
2016;3802 Holmestrand;6 år;9;23;14
2016;3802 Holmestrand;7 år;7;13;6
2016;3802 Holmestrand;8 år;6;13;7
2016;3802 Holmestrand;9 år;5;8;3
2016;3802 Holmestrand;10 år;4;8;4
2016;3802 Holmestrand;11 år;3;9;6
2016;3802 Holmestrand;12 år;7;12;5
2016;3802 Holmestrand;13 år;7;14;7
2016;3802 Holmestrand;14 år;4;10;6
2016;3802 Holmestrand;15 år;17;26;9
2016;3802 Holmestrand;16 år;16;18;2
2016;3802 Holmestrand;17 år;17;11;-6
2016;3802 Holmestrand;18 år;15;20;5
2016;3802 Holmestrand;19 år;35;21;-14
2016;3802 Holmestrand;20 år;51;31;-20
2016;3802 Holmestrand;21 år;62;42;-20
2016;3802 Holmestrand;22 år;52;34;-18
2016;3802 Holmestrand;23 år;52;38;-14
2016;3802 Holmestrand;24 år;53;40;-13
2016;3802 Holmestrand;25 år;47;56;9
2016;3802 Holmestrand;26 år;55;53;-2
2016;3802 Holmestrand;27 år;42;61;19
2016;3802 Holmestrand;28 år;39;42;3
2016;3802 Holmestrand;29 år;25;40;15
2016;3802 Holmestrand;30 år;29;44;15
2016;3802 Holmestrand;31 år;28;36;8
2016;3802 Holmestrand;32 år;16;35;19
2016;3802 Holmestrand;33 år;19;33;14
2016;3802 Holmestrand;34 år;27;36;9
2016;3802 Holmestrand;35 år;9;25;16
2016;3802 Holmestrand;36 år;16;28;12
2016;3802 Holmestrand;37 år;23;22;-1
2016;3802 Holmestrand;38 år;21;16;-5
2016;3802 Holmestrand;39 år;11;20;9
2016;3802 Holmestrand;40 år;16;18;2
2016;3802 Holmestrand;41 år;13;24;11
2016;3802 Holmestrand;42 år;12;14;2
2016;3802 Holmestrand;43 år;12;21;9
2016;3802 Holmestrand;44 år;13;20;7
2016;3802 Holmestrand;45 år;19;12;-7
2016;3802 Holmestrand;46 år;8;15;7
2016;3802 Holmestrand;47 år;15;16;1
2016;3802 Holmestrand;48 år;12;17;5
2016;3802 Holmestrand;49 år;12;19;7
2016;3802 Holmestrand;50 år;13;16;3
2016;3802 Holmestrand;51 år;17;16;-1
2016;3802 Holmestrand;52 år;8;15;7
2016;3802 Holmestrand;53 år;14;9;-5
2016;3802 Holmestrand;54 år;12;8;-4
2016;3802 Holmestrand;55 år;7;18;11
2016;3802 Holmestrand;56 år;10;10;0
2016;3802 Holmestrand;57 år;5;6;1
2016;3802 Holmestrand;58 år;8;15;7
2016;3802 Holmestrand;59 år;9;10;1
2016;3802 Holmestrand;60 år;4;10;6
2016;3802 Holmestrand;61 år;6;8;2
2016;3802 Holmestrand;62 år;9;14;5
2016;3802 Holmestrand;63 år;1;16;15
2016;3802 Holmestrand;64 år;2;9;7
2016;3802 Holmestrand;65 år;7;4;-3
2016;3802 Holmestrand;66 år;1;5;4
2016;3802 Holmestrand;67 år;6;5;-1
2016;3802 Holmestrand;68 år;8;15;7
2016;3802 Holmestrand;69 år;5;10;5
2016;3802 Holmestrand;70 år;9;5;-4
2016;3803 Tønsberg;0 år;26;24;-2
2016;3803 Tønsberg;1 år;46;54;8
2016;3803 Tønsberg;2 år;33;57;24
2016;3803 Tønsberg;3 år;31;42;11
2016;3803 Tønsberg;4 år;29;43;14
2016;3803 Tønsberg;5 år;34;39;5
2016;3803 Tønsberg;6 år;28;42;14
2016;3803 Tønsberg;7 år;20;23;3
2016;3803 Tønsberg;8 år;20;19;-1
2016;3803 Tønsberg;9 år;19;28;9
2016;3803 Tønsberg;10 år;16;26;10
2016;3803 Tønsberg;11 år;13;22;9
2016;3803 Tønsberg;12 år;19;25;6
2016;3803 Tønsberg;13 år;18;31;13
2016;3803 Tønsberg;14 år;19;23;4
2016;3803 Tønsberg;15 år;14;22;8
2016;3803 Tønsberg;16 år;32;52;20
2016;3803 Tønsberg;17 år;19;34;15
2016;3803 Tønsberg;18 år;38;48;10
2016;3803 Tønsberg;19 år;91;88;-3
2016;3803 Tønsberg;20 år;125;109;-16
2016;3803 Tønsberg;21 år;139;154;15
2016;3803 Tønsberg;22 år;109;132;23
2016;3803 Tønsberg;23 år;142;163;21
2016;3803 Tønsberg;24 år;141;144;3
2016;3803 Tønsberg;25 år;147;147;0
2016;3803 Tønsberg;26 år;148;152;4
2016;3803 Tønsberg;27 år;146;139;-7
2016;3803 Tønsberg;28 år;131;132;1
2016;3803 Tønsberg;29 år;107;90;-17
2016;3803 Tønsberg;30 år;95;99;4
2016;3803 Tønsberg;31 år;90;95;5
2016;3803 Tønsberg;32 år;71;76;5
2016;3803 Tønsberg;33 år;64;94;30
2016;3803 Tønsberg;34 år;47;62;15
2016;3803 Tønsberg;35 år;58;64;6
2016;3803 Tønsberg;36 år;45;60;15
2016;3803 Tønsberg;37 år;46;54;8
2016;3803 Tønsberg;38 år;53;46;-7
2016;3803 Tønsberg;39 år;45;44;-1
2016;3803 Tønsberg;40 år;43;37;-6
2016;3803 Tønsberg;41 år;37;48;11
2016;3803 Tønsberg;42 år;34;38;4
2016;3803 Tønsberg;43 år;33;45;12
2016;3803 Tønsberg;44 år;31;39;8
2016;3803 Tønsberg;45 år;32;42;10
2016;3803 Tønsberg;46 år;35;33;-2
2016;3803 Tønsberg;47 år;30;43;13
2016;3803 Tønsberg;48 år;32;37;5
2016;3803 Tønsberg;49 år;34;45;11
2016;3803 Tønsberg;50 år;28;31;3
2016;3803 Tønsberg;51 år;31;37;6
2016;3803 Tønsberg;52 år;31;29;-2
2016;3803 Tønsberg;53 år;27;33;6
2016;3803 Tønsberg;54 år;27;31;4
2016;3803 Tønsberg;55 år;28;31;3
2016;3803 Tønsberg;56 år;24;29;5
2016;3803 Tønsberg;57 år;16;35;19
2016;3803 Tønsberg;58 år;22;21;-1
2016;3803 Tønsberg;59 år;23;30;7
2016;3803 Tønsberg;60 år;16;20;4
2016;3803 Tønsberg;61 år;21;24;3
2016;3803 Tønsberg;62 år;17;16;-1
2016;3803 Tønsberg;63 år;16;15;-1
2016;3803 Tønsberg;64 år;14;16;2
2016;3803 Tønsberg;65 år;10;18;8
2016;3803 Tønsberg;66 år;9;12;3
2016;3803 Tønsberg;67 år;11;11;0
2016;3803 Tønsberg;68 år;9;13;4
2016;3803 Tønsberg;69 år;9;13;4
2016;3803 Tønsberg;70 år;13;11;-2
2016;3804 Sandefjord;0 år;21;26;5
2016;3804 Sandefjord;1 år;33;61;28
2016;3804 Sandefjord;2 år;30;55;25
2016;3804 Sandefjord;3 år;36;50;14
2016;3804 Sandefjord;4 år;25;45;20
2016;3804 Sandefjord;5 år;26;44;18
2016;3804 Sandefjord;6 år;28;32;4
2016;3804 Sandefjord;7 år;16;28;12
2016;3804 Sandefjord;8 år;11;28;17
2016;3804 Sandefjord;9 år;18;26;8
2016;3804 Sandefjord;10 år;16;26;10
2016;3804 Sandefjord;11 år;21;37;16
2016;3804 Sandefjord;12 år;12;35;23
2016;3804 Sandefjord;13 år;15;18;3
2016;3804 Sandefjord;14 år;9;34;25
2016;3804 Sandefjord;15 år;19;29;10
2016;3804 Sandefjord;16 år;26;46;20
2016;3804 Sandefjord;17 år;19;31;12
2016;3804 Sandefjord;18 år;26;65;39
2016;3804 Sandefjord;19 år;120;107;-13
2016;3804 Sandefjord;20 år;138;134;-4
2016;3804 Sandefjord;21 år;147;139;-8
2016;3804 Sandefjord;22 år;124;124;0
2016;3804 Sandefjord;23 år;139;141;2
2016;3804 Sandefjord;24 år;120;131;11
2016;3804 Sandefjord;25 år;121;137;16
2016;3804 Sandefjord;26 år;120;146;26
2016;3804 Sandefjord;27 år;121;117;-4
2016;3804 Sandefjord;28 år;94;106;12
2016;3804 Sandefjord;29 år;83;87;4
2016;3804 Sandefjord;30 år;71;92;21
2016;3804 Sandefjord;31 år;62;89;27
2016;3804 Sandefjord;32 år;42;66;24
2016;3804 Sandefjord;33 år;66;73;7
2016;3804 Sandefjord;34 år;39;62;23
2016;3804 Sandefjord;35 år;37;62;25
2016;3804 Sandefjord;36 år;42;61;19
2016;3804 Sandefjord;37 år;49;50;1
2016;3804 Sandefjord;38 år;31;43;12
2016;3804 Sandefjord;39 år;30;38;8
2016;3804 Sandefjord;40 år;29;45;16
2016;3804 Sandefjord;41 år;28;34;6
2016;3804 Sandefjord;42 år;23;42;19
2016;3804 Sandefjord;43 år;30;36;6
2016;3804 Sandefjord;44 år;23;26;3
2016;3804 Sandefjord;45 år;22;29;7
2016;3804 Sandefjord;46 år;27;26;-1
2016;3804 Sandefjord;47 år;34;38;4
2016;3804 Sandefjord;48 år;29;44;15
2016;3804 Sandefjord;49 år;23;28;5
2016;3804 Sandefjord;50 år;21;39;18
2016;3804 Sandefjord;51 år;25;32;7
2016;3804 Sandefjord;52 år;25;20;-5
2016;3804 Sandefjord;53 år;26;27;1
2016;3804 Sandefjord;54 år;28;24;-4
2016;3804 Sandefjord;55 år;28;27;-1
2016;3804 Sandefjord;56 år;26;18;-8
2016;3804 Sandefjord;57 år;22;20;-2
2016;3804 Sandefjord;58 år;17;29;12
2016;3804 Sandefjord;59 år;10;20;10
2016;3804 Sandefjord;60 år;10;17;7
2016;3804 Sandefjord;61 år;11;16;5
2016;3804 Sandefjord;62 år;12;18;6
2016;3804 Sandefjord;63 år;13;15;2
2016;3804 Sandefjord;64 år;5;12;7
2016;3804 Sandefjord;65 år;6;21;15
2016;3804 Sandefjord;66 år;9;20;11
2016;3804 Sandefjord;67 år;9;7;-2
2016;3804 Sandefjord;68 år;8;16;8
2016;3804 Sandefjord;69 år;6;14;8
2016;3804 Sandefjord;70 år;9;9;0
2016;3805 Larvik;0 år;8;23;15
2016;3805 Larvik;1 år;19;36;17
2016;3805 Larvik;2 år;15;31;16
2016;3805 Larvik;3 år;19;37;18
2016;3805 Larvik;4 år;20;18;-2
2016;3805 Larvik;5 år;20;24;4
2016;3805 Larvik;6 år;12;19;7
2016;3805 Larvik;7 år;17;18;1
2016;3805 Larvik;8 år;11;11;0
2016;3805 Larvik;9 år;12;21;9
2016;3805 Larvik;10 år;10;13;3
2016;3805 Larvik;11 år;10;13;3
2016;3805 Larvik;12 år;9;15;6
2016;3805 Larvik;13 år;7;17;10
2016;3805 Larvik;14 år;13;14;1
2016;3805 Larvik;15 år;11;15;4
2016;3805 Larvik;16 år;18;32;14
2016;3805 Larvik;17 år;15;28;13
2016;3805 Larvik;18 år;29;33;4
2016;3805 Larvik;19 år;69;49;-20
2016;3805 Larvik;20 år;78;45;-33
2016;3805 Larvik;21 år;90;44;-46
2016;3805 Larvik;22 år;68;61;-7
2016;3805 Larvik;23 år;72;75;3
2016;3805 Larvik;24 år;80;67;-13
2016;3805 Larvik;25 år;105;87;-18
2016;3805 Larvik;26 år;88;72;-16
2016;3805 Larvik;27 år;71;52;-19
2016;3805 Larvik;28 år;47;61;14
2016;3805 Larvik;29 år;56;57;1
2016;3805 Larvik;30 år;50;49;-1
2016;3805 Larvik;31 år;39;67;28
2016;3805 Larvik;32 år;40;51;11
2016;3805 Larvik;33 år;34;51;17
2016;3805 Larvik;34 år;21;49;28
2016;3805 Larvik;35 år;22;40;18
2016;3805 Larvik;36 år;26;29;3
2016;3805 Larvik;37 år;22;39;17
2016;3805 Larvik;38 år;17;33;16
2016;3805 Larvik;39 år;21;29;8
2016;3805 Larvik;40 år;17;27;10
2016;3805 Larvik;41 år;16;14;-2
2016;3805 Larvik;42 år;21;21;0
2016;3805 Larvik;43 år;17;33;16
2016;3805 Larvik;44 år;25;20;-5
2016;3805 Larvik;45 år;12;14;2
2016;3805 Larvik;46 år;21;14;-7
2016;3805 Larvik;47 år;11;17;6
2016;3805 Larvik;48 år;20;22;2
2016;3805 Larvik;49 år;11;17;6
2016;3805 Larvik;50 år;8;15;7
2016;3805 Larvik;51 år;18;19;1
2016;3805 Larvik;52 år;15;15;0
2016;3805 Larvik;53 år;9;17;8
2016;3805 Larvik;54 år;9;18;9
2016;3805 Larvik;55 år;17;14;-3
2016;3805 Larvik;56 år;12;20;8
2016;3805 Larvik;57 år;9;15;6
2016;3805 Larvik;58 år;11;14;3
2016;3805 Larvik;59 år;13;10;-3
2016;3805 Larvik;60 år;8;9;1
2016;3805 Larvik;61 år;3;11;8
2016;3805 Larvik;62 år;15;15;0
2016;3805 Larvik;63 år;10;5;-5
2016;3805 Larvik;64 år;6;9;3
2016;3805 Larvik;65 år;4;15;11
2016;3805 Larvik;66 år;3;6;3
2016;3805 Larvik;67 år;4;8;4
2016;3805 Larvik;68 år;7;8;1
2016;3805 Larvik;69 år;3;11;8
2016;3805 Larvik;70 år;3;6;3
2016;3811 Færder;0 år;3;14;11
2016;3811 Færder;1 år;24;30;6
2016;3811 Færder;2 år;21;27;6
2016;3811 Færder;3 år;13;23;10
2016;3811 Færder;4 år;17;25;8
2016;3811 Færder;5 år;11;22;11
2016;3811 Færder;6 år;22;15;-7
2016;3811 Færder;7 år;7;11;4
2016;3811 Færder;8 år;8;12;4
2016;3811 Færder;9 år;8;9;1
2016;3811 Færder;10 år;12;10;-2
2016;3811 Færder;11 år;2;7;5
2016;3811 Færder;12 år;11;12;1
2016;3811 Færder;13 år;4;11;7
2016;3811 Færder;14 år;7;10;3
2016;3811 Færder;15 år;11;14;3
2016;3811 Færder;16 år;17;18;1
2016;3811 Færder;17 år;19;18;-1
2016;3811 Færder;18 år;24;25;1
2016;3811 Færder;19 år;48;37;-11
2016;3811 Færder;20 år;78;47;-31
2016;3811 Færder;21 år;80;53;-27
2016;3811 Færder;22 år;68;58;-10
2016;3811 Færder;23 år;69;47;-22
2016;3811 Færder;24 år;76;63;-13
2016;3811 Færder;25 år;64;72;8
2016;3811 Færder;26 år;64;61;-3
2016;3811 Færder;27 år;65;64;-1
2016;3811 Færder;28 år;48;63;15
2016;3811 Færder;29 år;51;53;2
2016;3811 Færder;30 år;31;48;17
2016;3811 Færder;31 år;39;34;-5
2016;3811 Færder;32 år;34;45;11
2016;3811 Færder;33 år;28;43;15
2016;3811 Færder;34 år;29;29;0
2016;3811 Færder;35 år;25;26;1
2016;3811 Færder;36 år;22;28;6
2016;3811 Færder;37 år;21;26;5
2016;3811 Færder;38 år;19;29;10
2016;3811 Færder;39 år;12;21;9
2016;3811 Færder;40 år;26;18;-8
2016;3811 Færder;41 år;13;14;1
2016;3811 Færder;42 år;15;16;1
2016;3811 Færder;43 år;21;10;-11
2016;3811 Færder;44 år;11;21;10
2016;3811 Færder;45 år;19;17;-2
2016;3811 Færder;46 år;18;19;1
2016;3811 Færder;47 år;23;15;-8
2016;3811 Færder;48 år;6;14;8
2016;3811 Færder;49 år;26;14;-12
2016;3811 Færder;50 år;21;19;-2
2016;3811 Færder;51 år;14;19;5
2016;3811 Færder;52 år;16;11;-5
2016;3811 Færder;53 år;9;15;6
2016;3811 Færder;54 år;15;23;8
2016;3811 Færder;55 år;17;19;2
2016;3811 Færder;56 år;12;19;7
2016;3811 Færder;57 år;19;10;-9
2016;3811 Færder;58 år;13;15;2
2016;3811 Færder;59 år;16;15;-1
2016;3811 Færder;60 år;12;9;-3
2016;3811 Færder;61 år;9;10;1
2016;3811 Færder;62 år;10;12;2
2016;3811 Færder;63 år;7;10;3
2016;3811 Færder;64 år;5;17;12
2016;3811 Færder;65 år;8;12;4
2016;3811 Færder;66 år;5;9;4
2016;3811 Færder;67 år;3;8;5
2016;3811 Færder;68 år;7;10;3
2016;3811 Færder;69 år;7;6;-1
2016;3811 Færder;70 år;5;13;8
2017;3811 Færder;0 år;10;16;6
2017;3811 Færder;1 år;14;33;19
2017;3811 Færder;2 år;16;27;11
2017;3811 Færder;3 år;17;32;15
2017;3811 Færder;4 år;14;16;2
2017;3811 Færder;5 år;14;21;7
2017;3811 Færder;6 år;21;22;1
2017;3811 Færder;7 år;7;13;6
2017;3811 Færder;8 år;10;10;0
2017;3811 Færder;9 år;8;13;5
2017;3811 Færder;10 år;4;12;8
2017;3811 Færder;11 år;4;7;3
2017;3811 Færder;12 år;7;10;3
2017;3811 Færder;13 år;7;15;8
2017;3811 Færder;14 år;11;12;1
2017;3811 Færder;15 år;7;11;4
2017;3811 Færder;16 år;19;15;-4
2017;3811 Færder;17 år;16;23;7
2017;3811 Færder;18 år;22;22;0
2017;3811 Færder;19 år;48;27;-21
2017;3811 Færder;20 år;68;42;-26
2017;3811 Færder;21 år;75;53;-22
2017;3811 Færder;22 år;64;50;-14
2017;3811 Færder;23 år;79;54;-25
2017;3811 Færder;24 år;73;75;2
2017;3811 Færder;25 år;77;56;-21
2017;3811 Færder;26 år;77;59;-18
2017;3811 Færder;27 år;65;51;-14
2017;3811 Færder;28 år;55;48;-7
2017;3811 Færder;29 år;53;71;18
2017;3811 Færder;30 år;29;58;29
2017;3811 Færder;31 år;38;45;7
2017;3811 Færder;32 år;38;48;10
2017;3811 Færder;33 år;21;33;12
2017;3811 Færder;34 år;29;37;8
2017;3811 Færder;35 år;24;30;6
2017;3811 Færder;36 år;16;19;3
2017;3811 Færder;37 år;20;22;2
2017;3811 Færder;38 år;17;22;5
2017;3811 Færder;39 år;14;12;-2
2017;3811 Færder;40 år;12;22;10
2017;3811 Færder;41 år;16;25;9
2017;3811 Færder;42 år;13;19;6
2017;3811 Færder;43 år;13;17;4
2017;3811 Færder;44 år;14;18;4
2017;3811 Færder;45 år;13;22;9
2017;3811 Færder;46 år;17;17;0
2017;3811 Færder;47 år;20;16;-4
2017;3811 Færder;48 år;9;10;1
2017;3811 Færder;49 år;16;16;0
2017;3811 Færder;50 år;16;21;5
2017;3811 Færder;51 år;12;13;1
2017;3811 Færder;52 år;15;22;7
2017;3811 Færder;53 år;21;10;-11
2017;3811 Færder;54 år;18;17;-1
2017;3811 Færder;55 år;16;10;-6
2017;3811 Færder;56 år;18;16;-2
2017;3811 Færder;57 år;15;11;-4
2017;3811 Færder;58 år;10;17;7
2017;3811 Færder;59 år;10;15;5
2017;3811 Færder;60 år;11;15;4
2017;3811 Færder;61 år;5;7;2
2017;3811 Færder;62 år;5;11;6
2017;3811 Færder;63 år;12;19;7
2017;3811 Færder;64 år;9;10;1
2017;3811 Færder;65 år;10;15;5
2017;3811 Færder;66 år;9;7;-2
2017;3811 Færder;67 år;15;7;-8
2017;3811 Færder;68 år;8;5;-3
2017;3811 Færder;69 år;8;11;3
2017;3811 Færder;70 år;2;4;2
2017;3805 Larvik;0 år;10;20;10
2017;3805 Larvik;1 år;28;43;15
2017;3805 Larvik;2 år;21;45;24
2017;3805 Larvik;3 år;13;29;16
2017;3805 Larvik;4 år;16;36;20
2017;3805 Larvik;5 år;16;22;6
2017;3805 Larvik;6 år;10;19;9
2017;3805 Larvik;7 år;16;23;7
2017;3805 Larvik;8 år;20;11;-9
2017;3805 Larvik;9 år;15;21;6
2017;3805 Larvik;10 år;4;19;15
2017;3805 Larvik;11 år;24;20;-4
2017;3805 Larvik;12 år;12;16;4
2017;3805 Larvik;13 år;13;19;6
2017;3805 Larvik;14 år;8;17;9
2017;3805 Larvik;15 år;6;11;5
2017;3805 Larvik;16 år;16;23;7
2017;3805 Larvik;17 år;16;29;13
2017;3805 Larvik;18 år;25;33;8
2017;3805 Larvik;19 år;65;47;-18
2017;3805 Larvik;20 år;93;50;-43
2017;3805 Larvik;21 år;115;90;-25
2017;3805 Larvik;22 år;111;81;-30
2017;3805 Larvik;23 år;101;74;-27
2017;3805 Larvik;24 år;101;68;-33
2017;3805 Larvik;25 år;115;83;-32
2017;3805 Larvik;26 år;94;82;-12
2017;3805 Larvik;27 år;76;77;1
2017;3805 Larvik;28 år;61;73;12
2017;3805 Larvik;29 år;57;55;-2
2017;3805 Larvik;30 år;45;65;20
2017;3805 Larvik;31 år;36;64;28
2017;3805 Larvik;32 år;37;65;28
2017;3805 Larvik;33 år;38;37;-1
2017;3805 Larvik;34 år;24;44;20
2017;3805 Larvik;35 år;30;43;13
2017;3805 Larvik;36 år;32;37;5
2017;3805 Larvik;37 år;22;30;8
2017;3805 Larvik;38 år;24;36;12
2017;3805 Larvik;39 år;15;30;15
2017;3805 Larvik;40 år;32;33;1
2017;3805 Larvik;41 år;19;20;1
2017;3805 Larvik;42 år;20;31;11
2017;3805 Larvik;43 år;17;23;6
2017;3805 Larvik;44 år;16;22;6
2017;3805 Larvik;45 år;16;30;14
2017;3805 Larvik;46 år;22;21;-1
2017;3805 Larvik;47 år;15;17;2
2017;3805 Larvik;48 år;19;23;4
2017;3805 Larvik;49 år;19;21;2
2017;3805 Larvik;50 år;16;21;5
2017;3805 Larvik;51 år;10;17;7
2017;3805 Larvik;52 år;15;20;5
2017;3805 Larvik;53 år;15;21;6
2017;3805 Larvik;54 år;15;18;3
2017;3805 Larvik;55 år;10;8;-2
2017;3805 Larvik;56 år;15;13;-2
2017;3805 Larvik;57 år;10;16;6
2017;3805 Larvik;58 år;11;16;5
2017;3805 Larvik;59 år;11;20;9
2017;3805 Larvik;60 år;3;16;13
2017;3805 Larvik;61 år;8;11;3
2017;3805 Larvik;62 år;7;17;10
2017;3805 Larvik;63 år;9;12;3
2017;3805 Larvik;64 år;7;15;8
2017;3805 Larvik;65 år;6;13;7
2017;3805 Larvik;66 år;9;11;2
2017;3805 Larvik;67 år;4;9;5
2017;3805 Larvik;68 år;7;7;0
2017;3805 Larvik;69 år;7;9;2
2017;3805 Larvik;70 år;7;8;1
2017;3804 Sandefjord;0 år;18;31;13
2017;3804 Sandefjord;1 år;40;63;23
2017;3804 Sandefjord;2 år;41;55;14
2017;3804 Sandefjord;3 år;38;43;5
2017;3804 Sandefjord;4 år;29;44;15
2017;3804 Sandefjord;5 år;29;50;21
2017;3804 Sandefjord;6 år;26;35;9
2017;3804 Sandefjord;7 år;18;36;18
2017;3804 Sandefjord;8 år;21;36;15
2017;3804 Sandefjord;9 år;18;27;9
2017;3804 Sandefjord;10 år;13;27;14
2017;3804 Sandefjord;11 år;18;40;22
2017;3804 Sandefjord;12 år;15;18;3
2017;3804 Sandefjord;13 år;11;19;8
2017;3804 Sandefjord;14 år;17;15;-2
2017;3804 Sandefjord;15 år;18;26;8
2017;3804 Sandefjord;16 år;25;40;15
2017;3804 Sandefjord;17 år;30;39;9
2017;3804 Sandefjord;18 år;37;76;39
2017;3804 Sandefjord;19 år;111;127;16
2017;3804 Sandefjord;20 år;182;144;-38
2017;3804 Sandefjord;21 år;186;142;-44
2017;3804 Sandefjord;22 år;145;129;-16
2017;3804 Sandefjord;23 år;139;129;-10
2017;3804 Sandefjord;24 år;126;116;-10
2017;3804 Sandefjord;25 år;126;95;-31
2017;3804 Sandefjord;26 år;140;132;-8
2017;3804 Sandefjord;27 år;109;120;11
2017;3804 Sandefjord;28 år;103;124;21
2017;3804 Sandefjord;29 år;87;96;9
2017;3804 Sandefjord;30 år;59;85;26
2017;3804 Sandefjord;31 år;77;81;4
2017;3804 Sandefjord;32 år;44;70;26
2017;3804 Sandefjord;33 år;45;80;35
2017;3804 Sandefjord;34 år;50;60;10
2017;3804 Sandefjord;35 år;48;71;23
2017;3804 Sandefjord;36 år;51;66;15
2017;3804 Sandefjord;37 år;38;43;5
2017;3804 Sandefjord;38 år;47;41;-6
2017;3804 Sandefjord;39 år;29;40;11
2017;3804 Sandefjord;40 år;30;38;8
2017;3804 Sandefjord;41 år;46;39;-7
2017;3804 Sandefjord;42 år;27;40;13
2017;3804 Sandefjord;43 år;19;22;3
2017;3804 Sandefjord;44 år;24;23;-1
2017;3804 Sandefjord;45 år;28;34;6
2017;3804 Sandefjord;46 år;32;31;-1
2017;3804 Sandefjord;47 år;38;36;-2
2017;3804 Sandefjord;48 år;30;39;9
2017;3804 Sandefjord;49 år;31;31;0
2017;3804 Sandefjord;50 år;23;38;15
2017;3804 Sandefjord;51 år;29;35;6
2017;3804 Sandefjord;52 år;28;36;8
2017;3804 Sandefjord;53 år;22;26;4
2017;3804 Sandefjord;54 år;23;37;14
2017;3804 Sandefjord;55 år;18;24;6
2017;3804 Sandefjord;56 år;22;29;7
2017;3804 Sandefjord;57 år;8;23;15
2017;3804 Sandefjord;58 år;13;21;8
2017;3804 Sandefjord;59 år;17;18;1
2017;3804 Sandefjord;60 år;19;20;1
2017;3804 Sandefjord;61 år;10;16;6
2017;3804 Sandefjord;62 år;17;13;-4
2017;3804 Sandefjord;63 år;6;19;13
2017;3804 Sandefjord;64 år;12;17;5
2017;3804 Sandefjord;65 år;9;12;3
2017;3804 Sandefjord;66 år;12;10;-2
2017;3804 Sandefjord;67 år;8;12;4
2017;3804 Sandefjord;68 år;10;13;3
2017;3804 Sandefjord;69 år;8;14;6
2017;3804 Sandefjord;70 år;13;14;1
2017;3803 Tønsberg;0 år;25;34;9
2017;3803 Tønsberg;1 år;49;61;12
2017;3803 Tønsberg;2 år;35;55;20
2017;3803 Tønsberg;3 år;46;42;-4
2017;3803 Tønsberg;4 år;28;43;15
2017;3803 Tønsberg;5 år;30;37;7
2017;3803 Tønsberg;6 år;23;33;10
2017;3803 Tønsberg;7 år;20;30;10
2017;3803 Tønsberg;8 år;14;26;12
2017;3803 Tønsberg;9 år;25;24;-1
2017;3803 Tønsberg;10 år;17;20;3
2017;3803 Tønsberg;11 år;14;28;14
2017;3803 Tønsberg;12 år;17;26;9
2017;3803 Tønsberg;13 år;13;20;7
2017;3803 Tønsberg;14 år;13;19;6
2017;3803 Tønsberg;15 år;19;23;4
2017;3803 Tønsberg;16 år;28;45;17
2017;3803 Tønsberg;17 år;23;40;17
2017;3803 Tønsberg;18 år;42;50;8
2017;3803 Tønsberg;19 år;94;79;-15
2017;3803 Tønsberg;20 år;154;122;-32
2017;3803 Tønsberg;21 år;139;117;-22
2017;3803 Tønsberg;22 år;153;168;15
2017;3803 Tønsberg;23 år;134;152;18
2017;3803 Tønsberg;24 år;151;177;26
2017;3803 Tønsberg;25 år;151;155;4
2017;3803 Tønsberg;26 år;149;159;10
2017;3803 Tønsberg;27 år;126;153;27
2017;3803 Tønsberg;28 år;126;135;9
2017;3803 Tønsberg;29 år;100;116;16
2017;3803 Tønsberg;30 år;94;96;2
2017;3803 Tønsberg;31 år;65;107;42
2017;3803 Tønsberg;32 år;91;100;9
2017;3803 Tønsberg;33 år;67;74;7
2017;3803 Tønsberg;34 år;67;62;-5
2017;3803 Tønsberg;35 år;61;59;-2
2017;3803 Tønsberg;36 år;59;78;19
2017;3803 Tønsberg;37 år;39;53;14
2017;3803 Tønsberg;38 år;50;66;16
2017;3803 Tønsberg;39 år;34;45;11
2017;3803 Tønsberg;40 år;25;31;6
2017;3803 Tønsberg;41 år;35;49;14
2017;3803 Tønsberg;42 år;36;35;-1
2017;3803 Tønsberg;43 år;26;35;9
2017;3803 Tønsberg;44 år;40;28;-12
2017;3803 Tønsberg;45 år;33;36;3
2017;3803 Tønsberg;46 år;34;40;6
2017;3803 Tønsberg;47 år;33;44;11
2017;3803 Tønsberg;48 år;36;31;-5
2017;3803 Tønsberg;49 år;32;27;-5
2017;3803 Tønsberg;50 år;35;36;1
2017;3803 Tønsberg;51 år;24;28;4
2017;3803 Tønsberg;52 år;42;38;-4
2017;3803 Tønsberg;53 år;29;34;5
2017;3803 Tønsberg;54 år;28;43;15
2017;3803 Tønsberg;55 år;25;28;3
2017;3803 Tønsberg;56 år;27;30;3
2017;3803 Tønsberg;57 år;28;20;-8
2017;3803 Tønsberg;58 år;17;18;1
2017;3803 Tønsberg;59 år;17;18;1
2017;3803 Tønsberg;60 år;22;20;-2
2017;3803 Tønsberg;61 år;16;19;3
2017;3803 Tønsberg;62 år;13;14;1
2017;3803 Tønsberg;63 år;13;15;2
2017;3803 Tønsberg;64 år;10;16;6
2017;3803 Tønsberg;65 år;15;13;-2
2017;3803 Tønsberg;66 år;12;15;3
2017;3803 Tønsberg;67 år;13;22;9
2017;3803 Tønsberg;68 år;11;24;13
2017;3803 Tønsberg;69 år;12;14;2
2017;3803 Tønsberg;70 år;8;12;4
2017;3802 Holmestrand;0 år;6;16;10
2017;3802 Holmestrand;1 år;16;41;25
2017;3802 Holmestrand;2 år;10;21;11
2017;3802 Holmestrand;3 år;15;21;6
2017;3802 Holmestrand;4 år;12;18;6
2017;3802 Holmestrand;5 år;12;16;4
2017;3802 Holmestrand;6 år;7;22;15
2017;3802 Holmestrand;7 år;9;12;3
2017;3802 Holmestrand;8 år;6;19;13
2017;3802 Holmestrand;9 år;14;19;5
2017;3802 Holmestrand;10 år;13;4;-9
2017;3802 Holmestrand;11 år;7;17;10
2017;3802 Holmestrand;12 år;10;11;1
2017;3802 Holmestrand;13 år;10;7;-3
2017;3802 Holmestrand;14 år;11;10;-1
2017;3802 Holmestrand;15 år;9;4;-5
2017;3802 Holmestrand;16 år;17;14;-3
2017;3802 Holmestrand;17 år;6;8;2
2017;3802 Holmestrand;18 år;16;29;13
2017;3802 Holmestrand;19 år;44;26;-18
2017;3802 Holmestrand;20 år;49;38;-11
2017;3802 Holmestrand;21 år;45;39;-6
2017;3802 Holmestrand;22 år;45;52;7
2017;3802 Holmestrand;23 år;46;51;5
2017;3802 Holmestrand;24 år;55;59;4
2017;3802 Holmestrand;25 år;48;56;8
2017;3802 Holmestrand;26 år;53;54;1
2017;3802 Holmestrand;27 år;38;50;12
2017;3802 Holmestrand;28 år;43;54;11
2017;3802 Holmestrand;29 år;23;39;16
2017;3802 Holmestrand;30 år;38;42;4
2017;3802 Holmestrand;31 år;22;36;14
2017;3802 Holmestrand;32 år;20;38;18
2017;3802 Holmestrand;33 år;16;33;17
2017;3802 Holmestrand;34 år;15;25;10
2017;3802 Holmestrand;35 år;18;34;16
2017;3802 Holmestrand;36 år;16;17;1
2017;3802 Holmestrand;37 år;26;30;4
2017;3802 Holmestrand;38 år;22;25;3
2017;3802 Holmestrand;39 år;16;21;5
2017;3802 Holmestrand;40 år;16;26;10
2017;3802 Holmestrand;41 år;10;17;7
2017;3802 Holmestrand;42 år;16;27;11
2017;3802 Holmestrand;43 år;14;17;3
2017;3802 Holmestrand;44 år;15;22;7
2017;3802 Holmestrand;45 år;15;7;-8
2017;3802 Holmestrand;46 år;12;21;9
2017;3802 Holmestrand;47 år;15;15;0
2017;3802 Holmestrand;48 år;11;16;5
2017;3802 Holmestrand;49 år;9;18;9
2017;3802 Holmestrand;50 år;12;17;5
2017;3802 Holmestrand;51 år;20;12;-8
2017;3802 Holmestrand;52 år;12;17;5
2017;3802 Holmestrand;53 år;14;16;2
2017;3802 Holmestrand;54 år;15;12;-3
2017;3802 Holmestrand;55 år;5;12;7
2017;3802 Holmestrand;56 år;11;17;6
2017;3802 Holmestrand;57 år;5;16;11
2017;3802 Holmestrand;58 år;6;22;16
2017;3802 Holmestrand;59 år;7;14;7
2017;3802 Holmestrand;60 år;6;13;7
2017;3802 Holmestrand;61 år;4;18;14
2017;3802 Holmestrand;62 år;7;7;0
2017;3802 Holmestrand;63 år;6;19;13
2017;3802 Holmestrand;64 år;7;7;0
2017;3802 Holmestrand;65 år;8;5;-3
2017;3802 Holmestrand;66 år;4;13;9
2017;3802 Holmestrand;67 år;9;9;0
2017;3802 Holmestrand;68 år;7;5;-2
2017;3802 Holmestrand;69 år;6;8;2
2017;3802 Holmestrand;70 år;4;4;0
2017;3801 Horten;0 år;7;25;18
2017;3801 Horten;1 år;22;33;11
2017;3801 Horten;2 år;13;22;9
2017;3801 Horten;3 år;12;15;3
2017;3801 Horten;4 år;12;28;16
2017;3801 Horten;5 år;8;12;4
2017;3801 Horten;6 år;12;10;-2
2017;3801 Horten;7 år;8;10;2
2017;3801 Horten;8 år;11;11;0
2017;3801 Horten;9 år;7;11;4
2017;3801 Horten;10 år;7;7;0
2017;3801 Horten;11 år;8;7;-1
2017;3801 Horten;12 år;6;12;6
2017;3801 Horten;13 år;6;3;-3
2017;3801 Horten;14 år;9;9;0
2017;3801 Horten;15 år;7;11;4
2017;3801 Horten;16 år;19;17;-2
2017;3801 Horten;17 år;11;12;1
2017;3801 Horten;18 år;11;20;9
2017;3801 Horten;19 år;35;32;-3
2017;3801 Horten;20 år;72;55;-17
2017;3801 Horten;21 år;68;61;-7
2017;3801 Horten;22 år;74;72;-2
2017;3801 Horten;23 år;73;72;-1
2017;3801 Horten;24 år;101;71;-30
2017;3801 Horten;25 år;73;66;-7
2017;3801 Horten;26 år;64;80;16
2017;3801 Horten;27 år;53;57;4
2017;3801 Horten;28 år;43;60;17
2017;3801 Horten;29 år;43;44;1
2017;3801 Horten;30 år;37;44;7
2017;3801 Horten;31 år;35;36;1
2017;3801 Horten;32 år;34;38;4
2017;3801 Horten;33 år;17;23;6
2017;3801 Horten;34 år;18;18;0
2017;3801 Horten;35 år;21;26;5
2017;3801 Horten;36 år;15;23;8
2017;3801 Horten;37 år;21;24;3
2017;3801 Horten;38 år;23;20;-3
2017;3801 Horten;39 år;13;12;-1
2017;3801 Horten;40 år;10;15;5
2017;3801 Horten;41 år;14;13;-1
2017;3801 Horten;42 år;8;10;2
2017;3801 Horten;43 år;6;13;7
2017;3801 Horten;44 år;13;12;-1
2017;3801 Horten;45 år;7;15;8
2017;3801 Horten;46 år;16;15;-1
2017;3801 Horten;47 år;15;19;4
2017;3801 Horten;48 år;8;10;2
2017;3801 Horten;49 år;12;15;3
2017;3801 Horten;50 år;9;15;6
2017;3801 Horten;51 år;13;15;2
2017;3801 Horten;52 år;24;9;-15
2017;3801 Horten;53 år;8;13;5
2017;3801 Horten;54 år;9;7;-2
2017;3801 Horten;55 år;9;8;-1
2017;3801 Horten;56 år;14;7;-7
2017;3801 Horten;57 år;9;11;2
2017;3801 Horten;58 år;4;8;4
2017;3801 Horten;59 år;9;8;-1
2017;3801 Horten;60 år;7;6;-1
2017;3801 Horten;61 år;12;9;-3
2017;3801 Horten;62 år;5;12;7
2017;3801 Horten;63 år;4;9;5
2017;3801 Horten;64 år;6;7;1
2017;3801 Horten;65 år;5;8;3
2017;3801 Horten;66 år;8;7;-1
2017;3801 Horten;67 år;5;11;6
2017;3801 Horten;68 år;9;7;-2
2017;3801 Horten;69 år;3;7;4
2017;3801 Horten;70 år;4;6;2
2018;3801 Horten;0 år;6;12;6
2018;3801 Horten;1 år;22;26;4
2018;3801 Horten;2 år;7;29;22
2018;3801 Horten;3 år;14;16;2
2018;3801 Horten;4 år;19;19;0
2018;3801 Horten;5 år;13;10;-3
2018;3801 Horten;6 år;14;11;-3
2018;3801 Horten;7 år;4;8;4
2018;3801 Horten;8 år;9;11;2
2018;3801 Horten;9 år;11;11;0
2018;3801 Horten;10 år;5;18;13
2018;3801 Horten;11 år;7;7;0
2018;3801 Horten;12 år;9;12;3
2018;3801 Horten;13 år;10;8;-2
2018;3801 Horten;14 år;4;11;7
2018;3801 Horten;15 år;4;8;4
2018;3801 Horten;16 år;11;10;-1
2018;3801 Horten;17 år;13;20;7
2018;3801 Horten;18 år;13;20;7
2018;3801 Horten;19 år;43;44;1
2018;3801 Horten;20 år;48;46;-2
2018;3801 Horten;21 år;67;65;-2
2018;3801 Horten;22 år;65;69;4
2018;3801 Horten;23 år;78;66;-12
2018;3801 Horten;24 år;84;70;-14
2018;3801 Horten;25 år;77;66;-11
2018;3801 Horten;26 år;69;65;-4
2018;3801 Horten;27 år;52;53;1
2018;3801 Horten;28 år;56;50;-6
2018;3801 Horten;29 år;59;45;-14
2018;3801 Horten;30 år;57;47;-10
2018;3801 Horten;31 år;39;32;-7
2018;3801 Horten;32 år;40;31;-9
2018;3801 Horten;33 år;34;33;-1
2018;3801 Horten;34 år;23;23;0
2018;3801 Horten;35 år;20;22;2
2018;3801 Horten;36 år;26;30;4
2018;3801 Horten;37 år;21;30;9
2018;3801 Horten;38 år;13;15;2
2018;3801 Horten;39 år;17;24;7
2018;3801 Horten;40 år;11;12;1
2018;3801 Horten;41 år;11;19;8
2018;3801 Horten;42 år;8;8;0
2018;3801 Horten;43 år;11;12;1
2018;3801 Horten;44 år;11;17;6
2018;3801 Horten;45 år;10;12;2
2018;3801 Horten;46 år;15;15;0
2018;3801 Horten;47 år;17;14;-3
2018;3801 Horten;48 år;11;11;0
2018;3801 Horten;49 år;7;11;4
2018;3801 Horten;50 år;12;11;-1
2018;3801 Horten;51 år;9;7;-2
2018;3801 Horten;52 år;13;9;-4
2018;3801 Horten;53 år;13;11;-2
2018;3801 Horten;54 år;10;10;0
2018;3801 Horten;55 år;8;14;6
2018;3801 Horten;56 år;12;18;6
2018;3801 Horten;57 år;5;9;4
2018;3801 Horten;58 år;12;3;-9
2018;3801 Horten;59 år;13;5;-8
2018;3801 Horten;60 år;5;10;5
2018;3801 Horten;61 år;4;5;1
2018;3801 Horten;62 år;6;8;2
2018;3801 Horten;63 år;8;7;-1
2018;3801 Horten;64 år;5;4;-1
2018;3801 Horten;65 år;9;4;-5
2018;3801 Horten;66 år;5;7;2
2018;3801 Horten;67 år;4;7;3
2018;3801 Horten;68 år;3;2;-1
2018;3801 Horten;69 år;5;3;-2
2018;3801 Horten;70 år;6;6;0
2018;3802 Holmestrand;0 år;5;11;6
2018;3802 Holmestrand;1 år;13;25;12
2018;3802 Holmestrand;2 år;10;22;12
2018;3802 Holmestrand;3 år;13;21;8
2018;3802 Holmestrand;4 år;8;23;15
2018;3802 Holmestrand;5 år;9;17;8
2018;3802 Holmestrand;6 år;10;21;11
2018;3802 Holmestrand;7 år;9;9;0
2018;3802 Holmestrand;8 år;8;7;-1
2018;3802 Holmestrand;9 år;8;11;3
2018;3802 Holmestrand;10 år;12;8;-4
2018;3802 Holmestrand;11 år;7;6;-1
2018;3802 Holmestrand;12 år;10;10;0
2018;3802 Holmestrand;13 år;10;11;1
2018;3802 Holmestrand;14 år;8;10;2
2018;3802 Holmestrand;15 år;12;8;-4
2018;3802 Holmestrand;16 år;15;8;-7
2018;3802 Holmestrand;17 år;10;13;3
2018;3802 Holmestrand;18 år;10;15;5
2018;3802 Holmestrand;19 år;51;27;-24
2018;3802 Holmestrand;20 år;53;29;-24
2018;3802 Holmestrand;21 år;44;37;-7
2018;3802 Holmestrand;22 år;44;43;-1
2018;3802 Holmestrand;23 år;51;33;-18
2018;3802 Holmestrand;24 år;47;55;8
2018;3802 Holmestrand;25 år;42;50;8
2018;3802 Holmestrand;26 år;41;53;12
2018;3802 Holmestrand;27 år;43;57;14
2018;3802 Holmestrand;28 år;36;51;15
2018;3802 Holmestrand;29 år;44;54;10
2018;3802 Holmestrand;30 år;19;40;21
2018;3802 Holmestrand;31 år;30;49;19
2018;3802 Holmestrand;32 år;22;40;18
2018;3802 Holmestrand;33 år;16;34;18
2018;3802 Holmestrand;34 år;19;40;21
2018;3802 Holmestrand;35 år;23;30;7
2018;3802 Holmestrand;36 år;16;26;10
2018;3802 Holmestrand;37 år;19;26;7
2018;3802 Holmestrand;38 år;32;26;-6
2018;3802 Holmestrand;39 år;15;19;4
2018;3802 Holmestrand;40 år;17;11;-6
2018;3802 Holmestrand;41 år;11;18;7
2018;3802 Holmestrand;42 år;13;23;10
2018;3802 Holmestrand;43 år;12;16;4
2018;3802 Holmestrand;44 år;12;19;7
2018;3802 Holmestrand;45 år;9;19;10
2018;3802 Holmestrand;46 år;12;18;6
2018;3802 Holmestrand;47 år;13;24;11
2018;3802 Holmestrand;48 år;18;19;1
2018;3802 Holmestrand;49 år;8;20;12
2018;3802 Holmestrand;50 år;13;11;-2
2018;3802 Holmestrand;51 år;13;14;1
2018;3802 Holmestrand;52 år;14;24;10
2018;3802 Holmestrand;53 år;15;20;5
2018;3802 Holmestrand;54 år;12;16;4
2018;3802 Holmestrand;55 år;8;13;5
2018;3802 Holmestrand;56 år;5;9;4
2018;3802 Holmestrand;57 år;10;15;5
2018;3802 Holmestrand;58 år;7;13;6
2018;3802 Holmestrand;59 år;14;14;0
2018;3802 Holmestrand;60 år;6;4;-2
2018;3802 Holmestrand;61 år;11;12;1
2018;3802 Holmestrand;62 år;8;13;5
2018;3802 Holmestrand;63 år;6;12;6
2018;3802 Holmestrand;64 år;8;8;0
2018;3802 Holmestrand;65 år;7;7;0
2018;3802 Holmestrand;66 år;4;9;5
2018;3802 Holmestrand;67 år;6;9;3
2018;3802 Holmestrand;68 år;3;9;6
2018;3802 Holmestrand;69 år;4;8;4
2018;3802 Holmestrand;70 år;8;8;0
2018;3803 Tønsberg;0 år;19;24;5
2018;3803 Tønsberg;1 år;44;54;10
2018;3803 Tønsberg;2 år;34;40;6
2018;3803 Tønsberg;3 år;38;44;6
2018;3803 Tønsberg;4 år;36;55;19
2018;3803 Tønsberg;5 år;28;32;4
2018;3803 Tønsberg;6 år;30;38;8
2018;3803 Tønsberg;7 år;19;31;12
2018;3803 Tønsberg;8 år;18;20;2
2018;3803 Tønsberg;9 år;17;30;13
2018;3803 Tønsberg;10 år;10;28;18
2018;3803 Tønsberg;11 år;14;18;4
2018;3803 Tønsberg;12 år;17;18;1
2018;3803 Tønsberg;13 år;17;26;9
2018;3803 Tønsberg;14 år;21;35;14
2018;3803 Tønsberg;15 år;18;14;-4
2018;3803 Tønsberg;16 år;24;52;28
2018;3803 Tønsberg;17 år;27;40;13
2018;3803 Tønsberg;18 år;39;59;20
2018;3803 Tønsberg;19 år;88;95;7
2018;3803 Tønsberg;20 år;94;107;13
2018;3803 Tønsberg;21 år;149;135;-14
2018;3803 Tønsberg;22 år;136;140;4
2018;3803 Tønsberg;23 år;152;126;-26
2018;3803 Tønsberg;24 år;132;158;26
2018;3803 Tønsberg;25 år;149;148;-1
2018;3803 Tønsberg;26 år;154;179;25
2018;3803 Tønsberg;27 år;141;133;-8
2018;3803 Tønsberg;28 år;133;156;23
2018;3803 Tønsberg;29 år;121;140;19
2018;3803 Tønsberg;30 år;93;109;16
2018;3803 Tønsberg;31 år;69;102;33
2018;3803 Tønsberg;32 år;66;103;37
2018;3803 Tønsberg;33 år;73;74;1
2018;3803 Tønsberg;34 år;55;69;14
2018;3803 Tønsberg;35 år;60;58;-2
2018;3803 Tønsberg;36 år;54;55;1
2018;3803 Tønsberg;37 år;55;60;5
2018;3803 Tønsberg;38 år;44;48;4
2018;3803 Tønsberg;39 år;32;49;17
2018;3803 Tønsberg;40 år;31;43;12
2018;3803 Tønsberg;41 år;33;51;18
2018;3803 Tønsberg;42 år;34;36;2
2018;3803 Tønsberg;43 år;19;44;25
2018;3803 Tønsberg;44 år;40;43;3
2018;3803 Tønsberg;45 år;31;30;-1
2018;3803 Tønsberg;46 år;25;30;5
2018;3803 Tønsberg;47 år;36;40;4
2018;3803 Tønsberg;48 år;27;25;-2
2018;3803 Tønsberg;49 år;24;36;12
2018;3803 Tønsberg;50 år;28;47;19
2018;3803 Tønsberg;51 år;22;36;14
2018;3803 Tønsberg;52 år;26;46;20
2018;3803 Tønsberg;53 år;25;32;7
2018;3803 Tønsberg;54 år;23;32;9
2018;3803 Tønsberg;55 år;21;26;5
2018;3803 Tønsberg;56 år;20;28;8
2018;3803 Tønsberg;57 år;29;30;1
2018;3803 Tønsberg;58 år;16;23;7
2018;3803 Tønsberg;59 år;20;16;-4
2018;3803 Tønsberg;60 år;19;30;11
2018;3803 Tønsberg;61 år;14;14;0
2018;3803 Tønsberg;62 år;13;23;10
2018;3803 Tønsberg;63 år;18;16;-2
2018;3803 Tønsberg;64 år;16;21;5
2018;3803 Tønsberg;65 år;10;15;5
2018;3803 Tønsberg;66 år;9;28;19
2018;3803 Tønsberg;67 år;12;21;9
2018;3803 Tønsberg;68 år;16;11;-5
2018;3803 Tønsberg;69 år;11;13;2
2018;3803 Tønsberg;70 år;11;4;-7
2018;3804 Sandefjord;0 år;25;28;3
2018;3804 Sandefjord;1 år;35;56;21
2018;3804 Sandefjord;2 år;31;51;20
2018;3804 Sandefjord;3 år;30;46;16
2018;3804 Sandefjord;4 år;29;42;13
2018;3804 Sandefjord;5 år;22;39;17
2018;3804 Sandefjord;6 år;25;35;10
2018;3804 Sandefjord;7 år;22;32;10
2018;3804 Sandefjord;8 år;17;25;8
2018;3804 Sandefjord;9 år;16;26;10
2018;3804 Sandefjord;10 år;14;27;13
2018;3804 Sandefjord;11 år;11;20;9
2018;3804 Sandefjord;12 år;24;25;1
2018;3804 Sandefjord;13 år;15;32;17
2018;3804 Sandefjord;14 år;17;28;11
2018;3804 Sandefjord;15 år;15;18;3
2018;3804 Sandefjord;16 år;22;37;15
2018;3804 Sandefjord;17 år;29;21;-8
2018;3804 Sandefjord;18 år;42;74;32
2018;3804 Sandefjord;19 år;96;115;19
2018;3804 Sandefjord;20 år;139;125;-14
2018;3804 Sandefjord;21 år;126;123;-3
2018;3804 Sandefjord;22 år;129;123;-6
2018;3804 Sandefjord;23 år;117;120;3
2018;3804 Sandefjord;24 år;117;135;18
2018;3804 Sandefjord;25 år;112;127;15
2018;3804 Sandefjord;26 år;107;117;10
2018;3804 Sandefjord;27 år;120;122;2
2018;3804 Sandefjord;28 år;82;116;34
2018;3804 Sandefjord;29 år;81;95;14
2018;3804 Sandefjord;30 år;70;104;34
2018;3804 Sandefjord;31 år;63;75;12
2018;3804 Sandefjord;32 år;58;72;14
2018;3804 Sandefjord;33 år;50;57;7
2018;3804 Sandefjord;34 år;43;62;19
2018;3804 Sandefjord;35 år;43;56;13
2018;3804 Sandefjord;36 år;42;67;25
2018;3804 Sandefjord;37 år;35;58;23
2018;3804 Sandefjord;38 år;33;44;11
2018;3804 Sandefjord;39 år;32;40;8
2018;3804 Sandefjord;40 år;30;50;20
2018;3804 Sandefjord;41 år;39;48;9
2018;3804 Sandefjord;42 år;35;41;6
2018;3804 Sandefjord;43 år;23;30;7
2018;3804 Sandefjord;44 år;30;46;16
2018;3804 Sandefjord;45 år;26;23;-3
2018;3804 Sandefjord;46 år;36;44;8
2018;3804 Sandefjord;47 år;25;33;8
2018;3804 Sandefjord;48 år;23;32;9
2018;3804 Sandefjord;49 år;35;26;-9
2018;3804 Sandefjord;50 år;27;22;-5
2018;3804 Sandefjord;51 år;26;26;0
2018;3804 Sandefjord;52 år;30;20;-10
2018;3804 Sandefjord;53 år;24;27;3
2018;3804 Sandefjord;54 år;17;29;12
2018;3804 Sandefjord;55 år;26;32;6
2018;3804 Sandefjord;56 år;16;23;7
2018;3804 Sandefjord;57 år;23;23;0
2018;3804 Sandefjord;58 år;17;21;4
2018;3804 Sandefjord;59 år;18;17;-1
2018;3804 Sandefjord;60 år;19;19;0
2018;3804 Sandefjord;61 år;14;18;4
2018;3804 Sandefjord;62 år;14;12;-2
2018;3804 Sandefjord;63 år;16;15;-1
2018;3804 Sandefjord;64 år;9;10;1
2018;3804 Sandefjord;65 år;13;19;6
2018;3804 Sandefjord;66 år;14;14;0
2018;3804 Sandefjord;67 år;10;7;-3
2018;3804 Sandefjord;68 år;6;15;9
2018;3804 Sandefjord;69 år;9;9;0
2018;3804 Sandefjord;70 år;6;9;3
2018;3805 Larvik;0 år;10;28;18
2018;3805 Larvik;1 år;30;51;21
2018;3805 Larvik;2 år;23;45;22
2018;3805 Larvik;3 år;20;33;13
2018;3805 Larvik;4 år;17;30;13
2018;3805 Larvik;5 år;26;24;-2
2018;3805 Larvik;6 år;22;30;8
2018;3805 Larvik;7 år;11;7;-4
2018;3805 Larvik;8 år;17;12;-5
2018;3805 Larvik;9 år;16;18;2
2018;3805 Larvik;10 år;14;23;9
2018;3805 Larvik;11 år;8;10;2
2018;3805 Larvik;12 år;8;12;4
2018;3805 Larvik;13 år;9;13;4
2018;3805 Larvik;14 år;13;9;-4
2018;3805 Larvik;15 år;10;12;2
2018;3805 Larvik;16 år;14;20;6
2018;3805 Larvik;17 år;9;29;20
2018;3805 Larvik;18 år;18;22;4
2018;3805 Larvik;19 år;66;32;-34
2018;3805 Larvik;20 år;82;51;-31
2018;3805 Larvik;21 år;94;72;-22
2018;3805 Larvik;22 år;90;93;3
2018;3805 Larvik;23 år;82;91;9
2018;3805 Larvik;24 år;93;103;10
2018;3805 Larvik;25 år;101;76;-25
2018;3805 Larvik;26 år;67;88;21
2018;3805 Larvik;27 år;84;113;29
2018;3805 Larvik;28 år;64;69;5
2018;3805 Larvik;29 år;49;78;29
2018;3805 Larvik;30 år;44;67;23
2018;3805 Larvik;31 år;37;51;14
2018;3805 Larvik;32 år;44;67;23
2018;3805 Larvik;33 år;44;48;4
2018;3805 Larvik;34 år;44;49;5
2018;3805 Larvik;35 år;25;34;9
2018;3805 Larvik;36 år;31;22;-9
2018;3805 Larvik;37 år;28;29;1
2018;3805 Larvik;38 år;17;28;11
2018;3805 Larvik;39 år;13;25;12
2018;3805 Larvik;40 år;17;20;3
2018;3805 Larvik;41 år;25;26;1
2018;3805 Larvik;42 år;12;17;5
2018;3805 Larvik;43 år;10;23;13
2018;3805 Larvik;44 år;17;23;6
2018;3805 Larvik;45 år;21;20;-1
2018;3805 Larvik;46 år;32;24;-8
2018;3805 Larvik;47 år;24;24;0
2018;3805 Larvik;48 år;15;11;-4
2018;3805 Larvik;49 år;13;16;3
2018;3805 Larvik;50 år;22;15;-7
2018;3805 Larvik;51 år;13;12;-1
2018;3805 Larvik;52 år;19;18;-1
2018;3805 Larvik;53 år;9;15;6
2018;3805 Larvik;54 år;10;15;5
2018;3805 Larvik;55 år;16;15;-1
2018;3805 Larvik;56 år;4;10;6
2018;3805 Larvik;57 år;16;21;5
2018;3805 Larvik;58 år;2;15;13
2018;3805 Larvik;59 år;9;12;3
2018;3805 Larvik;60 år;11;11;0
2018;3805 Larvik;61 år;8;7;-1
2018;3805 Larvik;62 år;8;7;-1
2018;3805 Larvik;63 år;8;14;6
2018;3805 Larvik;64 år;10;12;2
2018;3805 Larvik;65 år;9;18;9
2018;3805 Larvik;66 år;6;10;4
2018;3805 Larvik;67 år;9;10;1
2018;3805 Larvik;68 år;8;13;5
2018;3805 Larvik;69 år;2;8;6
2018;3805 Larvik;70 år;6;10;4
2018;3811 Færder;0 år;7;21;14
2018;3811 Færder;1 år;25;30;5
2018;3811 Færder;2 år;14;19;5
2018;3811 Færder;3 år;15;19;4
2018;3811 Færder;4 år;14;19;5
2018;3811 Færder;5 år;5;22;17
2018;3811 Færder;6 år;13;15;2
2018;3811 Færder;7 år;9;7;-2
2018;3811 Færder;8 år;5;15;10
2018;3811 Færder;9 år;5;6;1
2018;3811 Færder;10 år;8;8;0
2018;3811 Færder;11 år;4;6;2
2018;3811 Færder;12 år;4;12;8
2018;3811 Færder;13 år;7;11;4
2018;3811 Færder;14 år;10;15;5
2018;3811 Færder;15 år;9;14;5
2018;3811 Færder;16 år;23;17;-6
2018;3811 Færder;17 år;15;10;-5
2018;3811 Færder;18 år;30;32;2
2018;3811 Færder;19 år;45;19;-26
2018;3811 Færder;20 år;44;29;-15
2018;3811 Færder;21 år;78;48;-30
2018;3811 Færder;22 år;69;46;-23
2018;3811 Færder;23 år;65;54;-11
2018;3811 Færder;24 år;71;45;-26
2018;3811 Færder;25 år;78;49;-29
2018;3811 Færder;26 år;84;62;-22
2018;3811 Færder;27 år;46;62;16
2018;3811 Færder;28 år;62;50;-12
2018;3811 Færder;29 år;50;42;-8
2018;3811 Færder;30 år;45;51;6
2018;3811 Færder;31 år;33;36;3
2018;3811 Færder;32 år;31;29;-2
2018;3811 Færder;33 år;30;26;-4
2018;3811 Færder;34 år;24;33;9
2018;3811 Færder;35 år;21;25;4
2018;3811 Færder;36 år;19;32;13
2018;3811 Færder;37 år;15;27;12
2018;3811 Færder;38 år;15;17;2
2018;3811 Færder;39 år;21;17;-4
2018;3811 Færder;40 år;15;16;1
2018;3811 Færder;41 år;15;19;4
2018;3811 Færder;42 år;13;15;2
2018;3811 Færder;43 år;16;12;-4
2018;3811 Færder;44 år;23;25;2
2018;3811 Færder;45 år;11;11;0
2018;3811 Færder;46 år;12;9;-3
2018;3811 Færder;47 år;13;18;5
2018;3811 Færder;48 år;11;17;6
2018;3811 Færder;49 år;10;15;5
2018;3811 Færder;50 år;20;16;-4
2018;3811 Færder;51 år;16;22;6
2018;3811 Færder;52 år;27;16;-11
2018;3811 Færder;53 år;18;14;-4
2018;3811 Færder;54 år;11;6;-5
2018;3811 Færder;55 år;8;10;2
2018;3811 Færder;56 år;9;14;5
2018;3811 Færder;57 år;18;15;-3
2018;3811 Færder;58 år;10;17;7
2018;3811 Færder;59 år;9;6;-3
2018;3811 Færder;60 år;13;13;0
2018;3811 Færder;61 år;4;10;6
2018;3811 Færder;62 år;10;8;-2
2018;3811 Færder;63 år;8;8;0
2018;3811 Færder;64 år;11;20;9
2018;3811 Færder;65 år;8;11;3
2018;3811 Færder;66 år;18;11;-7
2018;3811 Færder;67 år;7;9;2
2018;3811 Færder;68 år;6;6;0
2018;3811 Færder;69 år;6;13;7
2018;3811 Færder;70 år;3;7;4
2019;3811 Færder;0 år;11;16;5
2019;3811 Færder;1 år;18;26;8
2019;3811 Færder;2 år;7;22;15
2019;3811 Færder;3 år;13;31;18
2019;3811 Færder;4 år;7;15;8
2019;3811 Færder;5 år;11;16;5
2019;3811 Færder;6 år;8;15;7
2019;3811 Færder;7 år;9;9;0
2019;3811 Færder;8 år;9;15;6
2019;3811 Færder;9 år;10;16;6
2019;3811 Færder;10 år;4;12;8
2019;3811 Færder;11 år;13;11;-2
2019;3811 Færder;12 år;9;11;2
2019;3811 Færder;13 år;9;13;4
2019;3811 Færder;14 år;10;13;3
2019;3811 Færder;15 år;14;11;-3
2019;3811 Færder;16 år;6;13;7
2019;3811 Færder;17 år;15;11;-4
2019;3811 Færder;18 år;17;23;6
2019;3811 Færder;19 år;47;38;-9
2019;3811 Færder;20 år;32;23;-9
2019;3811 Færder;21 år;60;27;-33
2019;3811 Færder;22 år;53;45;-8
2019;3811 Færder;23 år;58;47;-11
2019;3811 Færder;24 år;43;44;1
2019;3811 Færder;25 år;52;36;-16
2019;3811 Færder;26 år;72;30;-42
2019;3811 Færder;27 år;52;49;-3
2019;3811 Færder;28 år;56;43;-13
2019;3811 Færder;29 år;31;40;9
2019;3811 Færder;30 år;34;42;8
2019;3811 Færder;31 år;20;42;22
2019;3811 Færder;32 år;26;31;5
2019;3811 Færder;33 år;28;32;4
2019;3811 Færder;34 år;19;39;20
2019;3811 Færder;35 år;25;22;-3
2019;3811 Færder;36 år;16;24;8
2019;3811 Færder;37 år;16;19;3
2019;3811 Færder;38 år;14;16;2
2019;3811 Færder;39 år;10;22;12
2019;3811 Færder;40 år;12;16;4
2019;3811 Færder;41 år;14;28;14
2019;3811 Færder;42 år;12;17;5
2019;3811 Færder;43 år;18;16;-2
2019;3811 Færder;44 år;12;12;0
2019;3811 Færder;45 år;15;20;5
2019;3811 Færder;46 år;12;17;5
2019;3811 Færder;47 år;9;16;7
2019;3811 Færder;48 år;12;15;3
2019;3811 Færder;49 år;17;11;-6
2019;3811 Færder;50 år;12;14;2
2019;3811 Færder;51 år;16;14;-2
2019;3811 Færder;52 år;19;16;-3
2019;3811 Færder;53 år;24;13;-11
2019;3811 Færder;54 år;11;11;0
2019;3811 Færder;55 år;20;19;-1
2019;3811 Færder;56 år;15;11;-4
2019;3811 Færder;57 år;14;15;1
2019;3811 Færder;58 år;8;5;-3
2019;3811 Færder;59 år;12;25;13
2019;3811 Færder;60 år;8;15;7
2019;3811 Færder;61 år;11;15;4
2019;3811 Færder;62 år;12;11;-1
2019;3811 Færder;63 år;10;11;1
2019;3811 Færder;64 år;12;7;-5
2019;3811 Færder;65 år;10;9;-1
2019;3811 Færder;66 år;6;9;3
2019;3811 Færder;67 år;9;12;3
2019;3811 Færder;68 år;6;7;1
2019;3811 Færder;69 år;7;8;1
2019;3811 Færder;70 år;8;12;4
2019;3805 Larvik;0 år;10;16;6
2019;3805 Larvik;1 år;19;32;13
2019;3805 Larvik;2 år;24;35;11
2019;3805 Larvik;3 år;27;31;4
2019;3805 Larvik;4 år;18;20;2
2019;3805 Larvik;5 år;18;25;7
2019;3805 Larvik;6 år;19;18;-1
2019;3805 Larvik;7 år;13;18;5
2019;3805 Larvik;8 år;9;5;-4
2019;3805 Larvik;9 år;13;19;6
2019;3805 Larvik;10 år;6;8;2
2019;3805 Larvik;11 år;16;14;-2
2019;3805 Larvik;12 år;6;17;11
2019;3805 Larvik;13 år;8;20;12
2019;3805 Larvik;14 år;11;13;2
2019;3805 Larvik;15 år;15;13;-2
2019;3805 Larvik;16 år;6;23;17
2019;3805 Larvik;17 år;16;19;3
2019;3805 Larvik;18 år;19;20;1
2019;3805 Larvik;19 år;70;33;-37
2019;3805 Larvik;20 år;83;46;-37
2019;3805 Larvik;21 år;75;60;-15
2019;3805 Larvik;22 år;94;67;-27
2019;3805 Larvik;23 år;84;76;-8
2019;3805 Larvik;24 år;83;62;-21
2019;3805 Larvik;25 år;109;61;-48
2019;3805 Larvik;26 år;83;53;-30
2019;3805 Larvik;27 år;75;52;-23
2019;3805 Larvik;28 år;83;69;-14
2019;3805 Larvik;29 år;62;59;-3
2019;3805 Larvik;30 år;62;63;1
2019;3805 Larvik;31 år;46;44;-2
2019;3805 Larvik;32 år;30;55;25
2019;3805 Larvik;33 år;32;50;18
2019;3805 Larvik;34 år;38;42;4
2019;3805 Larvik;35 år;25;37;12
2019;3805 Larvik;36 år;19;28;9
2019;3805 Larvik;37 år;16;31;15
2019;3805 Larvik;38 år;10;26;16
2019;3805 Larvik;39 år;14;19;5
2019;3805 Larvik;40 år;23;21;-2
2019;3805 Larvik;41 år;11;25;14
2019;3805 Larvik;42 år;21;17;-4
2019;3805 Larvik;43 år;14;22;8
2019;3805 Larvik;44 år;24;21;-3
2019;3805 Larvik;45 år;9;12;3
2019;3805 Larvik;46 år;25;20;-5
2019;3805 Larvik;47 år;12;22;10
2019;3805 Larvik;48 år;16;24;8
2019;3805 Larvik;49 år;9;19;10
2019;3805 Larvik;50 år;11;29;18
2019;3805 Larvik;51 år;10;13;3
2019;3805 Larvik;52 år;8;12;4
2019;3805 Larvik;53 år;12;17;5
2019;3805 Larvik;54 år;15;11;-4
2019;3805 Larvik;55 år;14;15;1
2019;3805 Larvik;56 år;18;13;-5
2019;3805 Larvik;57 år;12;15;3
2019;3805 Larvik;58 år;7;12;5
2019;3805 Larvik;59 år;6;9;3
2019;3805 Larvik;60 år;9;11;2
2019;3805 Larvik;61 år;17;11;-6
2019;3805 Larvik;62 år;8;14;6
2019;3805 Larvik;63 år;8;12;4
2019;3805 Larvik;64 år;7;14;7
2019;3805 Larvik;65 år;9;17;8
2019;3805 Larvik;66 år;16;12;-4
2019;3805 Larvik;67 år;13;19;6
2019;3805 Larvik;68 år;8;9;1
2019;3805 Larvik;69 år;8;5;-3
2019;3805 Larvik;70 år;9;7;-2
2019;3804 Sandefjord;0 år;13;32;19
2019;3804 Sandefjord;1 år;28;66;38
2019;3804 Sandefjord;2 år;22;50;28
2019;3804 Sandefjord;3 år;25;52;27
2019;3804 Sandefjord;4 år;22;33;11
2019;3804 Sandefjord;5 år;20;40;20
2019;3804 Sandefjord;6 år;23;41;18
2019;3804 Sandefjord;7 år;13;28;15
2019;3804 Sandefjord;8 år;12;32;20
2019;3804 Sandefjord;9 år;14;26;12
2019;3804 Sandefjord;10 år;13;25;12
2019;3804 Sandefjord;11 år;15;22;7
2019;3804 Sandefjord;12 år;17;25;8
2019;3804 Sandefjord;13 år;25;15;-10
2019;3804 Sandefjord;14 år;12;26;14
2019;3804 Sandefjord;15 år;16;23;7
2019;3804 Sandefjord;16 år;15;27;12
2019;3804 Sandefjord;17 år;21;31;10
2019;3804 Sandefjord;18 år;27;43;16
2019;3804 Sandefjord;19 år;104;62;-42
2019;3804 Sandefjord;20 år;159;80;-79
2019;3804 Sandefjord;21 år;202;99;-103
2019;3804 Sandefjord;22 år;158;90;-68
2019;3804 Sandefjord;23 år;151;133;-18
2019;3804 Sandefjord;24 år;127;93;-34
2019;3804 Sandefjord;25 år;117;104;-13
2019;3804 Sandefjord;26 år;106;113;7
2019;3804 Sandefjord;27 år;98;90;-8
2019;3804 Sandefjord;28 år;80;101;21
2019;3804 Sandefjord;29 år;77;99;22
2019;3804 Sandefjord;30 år;73;97;24
2019;3804 Sandefjord;31 år;50;85;35
2019;3804 Sandefjord;32 år;52;60;8
2019;3804 Sandefjord;33 år;53;97;44
2019;3804 Sandefjord;34 år;49;70;21
2019;3804 Sandefjord;35 år;36;56;20
2019;3804 Sandefjord;36 år;34;60;26
2019;3804 Sandefjord;37 år;37;71;34
2019;3804 Sandefjord;38 år;26;46;20
2019;3804 Sandefjord;39 år;36;42;6
2019;3804 Sandefjord;40 år;23;36;13
2019;3804 Sandefjord;41 år;31;30;-1
2019;3804 Sandefjord;42 år;20;41;21
2019;3804 Sandefjord;43 år;25;26;1
2019;3804 Sandefjord;44 år;22;32;10
2019;3804 Sandefjord;45 år;22;25;3
2019;3804 Sandefjord;46 år;18;32;14
2019;3804 Sandefjord;47 år;22;33;11
2019;3804 Sandefjord;48 år;16;33;17
2019;3804 Sandefjord;49 år;21;32;11
2019;3804 Sandefjord;50 år;24;20;-4
2019;3804 Sandefjord;51 år;20;28;8
2019;3804 Sandefjord;52 år;18;24;6
2019;3804 Sandefjord;53 år;19;22;3
2019;3804 Sandefjord;54 år;19;22;3
2019;3804 Sandefjord;55 år;22;26;4
2019;3804 Sandefjord;56 år;21;30;9
2019;3804 Sandefjord;57 år;8;25;17
2019;3804 Sandefjord;58 år;14;20;6
2019;3804 Sandefjord;59 år;15;15;0
2019;3804 Sandefjord;60 år;11;11;0
2019;3804 Sandefjord;61 år;18;16;-2
2019;3804 Sandefjord;62 år;10;18;8
2019;3804 Sandefjord;63 år;7;13;6
2019;3804 Sandefjord;64 år;15;21;6
2019;3804 Sandefjord;65 år;15;13;-2
2019;3804 Sandefjord;66 år;7;17;10
2019;3804 Sandefjord;67 år;12;17;5
2019;3804 Sandefjord;68 år;8;11;3
2019;3804 Sandefjord;69 år;5;10;5
2019;3804 Sandefjord;70 år;5;10;5
2019;3803 Tønsberg;0 år;25;33;8
2019;3803 Tønsberg;1 år;32;47;15
2019;3803 Tønsberg;2 år;35;40;5
2019;3803 Tønsberg;3 år;27;39;12
2019;3803 Tønsberg;4 år;33;35;2
2019;3803 Tønsberg;5 år;23;32;9
2019;3803 Tønsberg;6 år;23;27;4
2019;3803 Tønsberg;7 år;20;14;-6
2019;3803 Tønsberg;8 år;16;15;-1
2019;3803 Tønsberg;9 år;23;24;1
2019;3803 Tønsberg;10 år;10;20;10
2019;3803 Tønsberg;11 år;13;24;11
2019;3803 Tønsberg;12 år;17;14;-3
2019;3803 Tønsberg;13 år;16;26;10
2019;3803 Tønsberg;14 år;16;20;4
2019;3803 Tønsberg;15 år;15;21;6
2019;3803 Tønsberg;16 år;19;19;0
2019;3803 Tønsberg;17 år;20;31;11
2019;3803 Tønsberg;18 år;34;37;3
2019;3803 Tønsberg;19 år;76;60;-16
2019;3803 Tønsberg;20 år;82;62;-20
2019;3803 Tønsberg;21 år;108;112;4
2019;3803 Tønsberg;22 år;92;77;-15
2019;3803 Tønsberg;23 år;105;99;-6
2019;3803 Tønsberg;24 år;112;102;-10
2019;3803 Tønsberg;25 år;105;85;-20
2019;3803 Tønsberg;26 år;124;115;-9
2019;3803 Tønsberg;27 år;84;92;8
2019;3803 Tønsberg;28 år;102;98;-4
2019;3803 Tønsberg;29 år;83;94;11
2019;3803 Tønsberg;30 år;79;83;4
2019;3803 Tønsberg;31 år;68;56;-12
2019;3803 Tønsberg;32 år;55;77;22
2019;3803 Tønsberg;33 år;65;85;20
2019;3803 Tønsberg;34 år;57;58;1
2019;3803 Tønsberg;35 år;35;62;27
2019;3803 Tønsberg;36 år;47;50;3
2019;3803 Tønsberg;37 år;33;54;21
2019;3803 Tønsberg;38 år;36;57;21
2019;3803 Tønsberg;39 år;27;38;11
2019;3803 Tønsberg;40 år;41;44;3
2019;3803 Tønsberg;41 år;25;41;16
2019;3803 Tønsberg;42 år;20;33;13
2019;3803 Tønsberg;43 år;27;26;-1
2019;3803 Tønsberg;44 år;19;24;5
2019;3803 Tønsberg;45 år;18;26;8
2019;3803 Tønsberg;46 år;19;25;6
2019;3803 Tønsberg;47 år;20;36;16
2019;3803 Tønsberg;48 år;23;29;6
2019;3803 Tønsberg;49 år;29;35;6
2019;3803 Tønsberg;50 år;28;26;-2
2019;3803 Tønsberg;51 år;20;31;11
2019;3803 Tønsberg;52 år;30;32;2
2019;3803 Tønsberg;53 år;25;32;7
2019;3803 Tønsberg;54 år;17;31;14
2019;3803 Tønsberg;55 år;16;36;20
2019;3803 Tønsberg;56 år;27;35;8
2019;3803 Tønsberg;57 år;16;30;14
2019;3803 Tønsberg;58 år;14;18;4
2019;3803 Tønsberg;59 år;15;30;15
2019;3803 Tønsberg;60 år;12;22;10
2019;3803 Tønsberg;61 år;18;24;6
2019;3803 Tønsberg;62 år;17;15;-2
2019;3803 Tønsberg;63 år;12;16;4
2019;3803 Tønsberg;64 år;4;24;20
2019;3803 Tønsberg;65 år;11;16;5
2019;3803 Tønsberg;66 år;9;12;3
2019;3803 Tønsberg;67 år;16;23;7
2019;3803 Tønsberg;68 år;9;12;3
2019;3803 Tønsberg;69 år;10;16;6
2019;3803 Tønsberg;70 år;10;17;7
2019;3802 Holmestrand;0 år;6;8;2
2019;3802 Holmestrand;1 år;12;15;3
2019;3802 Holmestrand;2 år;14;14;0
2019;3802 Holmestrand;3 år;15;14;-1
2019;3802 Holmestrand;4 år;13;15;2
2019;3802 Holmestrand;5 år;13;12;-1
2019;3802 Holmestrand;6 år;3;13;10
2019;3802 Holmestrand;7 år;12;10;-2
2019;3802 Holmestrand;8 år;7;10;3
2019;3802 Holmestrand;9 år;6;10;4
2019;3802 Holmestrand;10 år;7;11;4
2019;3802 Holmestrand;11 år;5;9;4
2019;3802 Holmestrand;12 år;4;10;6
2019;3802 Holmestrand;13 år;4;11;7
2019;3802 Holmestrand;14 år;5;7;2
2019;3802 Holmestrand;15 år;8;7;-1
2019;3802 Holmestrand;16 år;8;8;0
2019;3802 Holmestrand;17 år;6;7;1
2019;3802 Holmestrand;18 år;14;13;-1
2019;3802 Holmestrand;19 år;28;19;-9
2019;3802 Holmestrand;20 år;44;25;-19
2019;3802 Holmestrand;21 år;37;36;-1
2019;3802 Holmestrand;22 år;45;38;-7
2019;3802 Holmestrand;23 år;30;35;5
2019;3802 Holmestrand;24 år;30;28;-2
2019;3802 Holmestrand;25 år;40;33;-7
2019;3802 Holmestrand;26 år;37;36;-1
2019;3802 Holmestrand;27 år;46;34;-12
2019;3802 Holmestrand;28 år;28;26;-2
2019;3802 Holmestrand;29 år;20;34;14
2019;3802 Holmestrand;30 år;20;35;15
2019;3802 Holmestrand;31 år;20;29;9
2019;3802 Holmestrand;32 år;19;23;4
2019;3802 Holmestrand;33 år;19;20;1
2019;3802 Holmestrand;34 år;14;22;8
2019;3802 Holmestrand;35 år;21;14;-7
2019;3802 Holmestrand;36 år;12;19;7
2019;3802 Holmestrand;37 år;16;16;0
2019;3802 Holmestrand;38 år;13;17;4
2019;3802 Holmestrand;39 år;16;19;3
2019;3802 Holmestrand;40 år;10;9;-1
2019;3802 Holmestrand;41 år;8;16;8
2019;3802 Holmestrand;42 år;9;16;7
2019;3802 Holmestrand;43 år;7;16;9
2019;3802 Holmestrand;44 år;16;13;-3
2019;3802 Holmestrand;45 år;12;12;0
2019;3802 Holmestrand;46 år;8;11;3
2019;3802 Holmestrand;47 år;13;8;-5
2019;3802 Holmestrand;48 år;10;9;-1
2019;3802 Holmestrand;49 år;9;13;4
2019;3802 Holmestrand;50 år;6;12;6
2019;3802 Holmestrand;51 år;14;9;-5
2019;3802 Holmestrand;52 år;11;9;-2
2019;3802 Holmestrand;53 år;11;12;1
2019;3802 Holmestrand;54 år;11;12;1
2019;3802 Holmestrand;55 år;8;12;4
2019;3802 Holmestrand;56 år;9;15;6
2019;3802 Holmestrand;57 år;6;11;5
2019;3802 Holmestrand;58 år;9;12;3
2019;3802 Holmestrand;59 år;4;9;5
2019;3802 Holmestrand;60 år;8;13;5
2019;3802 Holmestrand;61 år;4;10;6
2019;3802 Holmestrand;62 år;5;15;10
2019;3802 Holmestrand;63 år;11;11;0
2019;3802 Holmestrand;64 år;6;4;-2
2019;3802 Holmestrand;65 år;11;7;-4
2019;3802 Holmestrand;66 år;4;12;8
2019;3802 Holmestrand;67 år;5;10;5
2019;3802 Holmestrand;68 år;4;4;0
2019;3802 Holmestrand;69 år;3;7;4
2019;3802 Holmestrand;70 år;;6;6
2019;3801 Horten;0 år;7;13;6
2019;3801 Horten;1 år;9;18;9
2019;3801 Horten;2 år;15;11;-4
2019;3801 Horten;3 år;14;16;2
2019;3801 Horten;4 år;12;14;2
2019;3801 Horten;5 år;11;13;2
2019;3801 Horten;6 år;14;9;-5
2019;3801 Horten;7 år;6;9;3
2019;3801 Horten;8 år;11;10;-1
2019;3801 Horten;9 år;5;10;5
2019;3801 Horten;10 år;11;8;-3
2019;3801 Horten;11 år;6;6;0
2019;3801 Horten;12 år;6;9;3
2019;3801 Horten;13 år;11;7;-4
2019;3801 Horten;14 år;7;5;-2
2019;3801 Horten;15 år;5;7;2
2019;3801 Horten;16 år;6;11;5
2019;3801 Horten;17 år;13;12;-1
2019;3801 Horten;18 år;20;13;-7
2019;3801 Horten;19 år;33;32;-1
2019;3801 Horten;20 år;53;42;-11
2019;3801 Horten;21 år;66;49;-17
2019;3801 Horten;22 år;59;56;-3
2019;3801 Horten;23 år;55;55;0
2019;3801 Horten;24 år;59;54;-5
2019;3801 Horten;25 år;68;73;5
2019;3801 Horten;26 år;46;57;11
2019;3801 Horten;27 år;44;52;8
2019;3801 Horten;28 år;46;56;10
2019;3801 Horten;29 år;41;40;-1
2019;3801 Horten;30 år;33;28;-5
2019;3801 Horten;31 år;30;32;2
2019;3801 Horten;32 år;18;36;18
2019;3801 Horten;33 år;22;29;7
2019;3801 Horten;34 år;16;23;7
2019;3801 Horten;35 år;19;19;0
2019;3801 Horten;36 år;14;25;11
2019;3801 Horten;37 år;14;23;9
2019;3801 Horten;38 år;13;18;5
2019;3801 Horten;39 år;10;17;7
2019;3801 Horten;40 år;15;15;0
2019;3801 Horten;41 år;11;9;-2
2019;3801 Horten;42 år;12;17;5
2019;3801 Horten;43 år;10;14;4
2019;3801 Horten;44 år;8;15;7
2019;3801 Horten;45 år;15;13;-2
2019;3801 Horten;46 år;10;10;0
2019;3801 Horten;47 år;12;14;2
2019;3801 Horten;48 år;14;10;-4
2019;3801 Horten;49 år;13;16;3
2019;3801 Horten;50 år;11;10;-1
2019;3801 Horten;51 år;9;10;1
2019;3801 Horten;52 år;10;10;0
2019;3801 Horten;53 år;10;10;0
2019;3801 Horten;54 år;11;14;3
2019;3801 Horten;55 år;8;12;4
2019;3801 Horten;56 år;11;6;-5
2019;3801 Horten;57 år;14;6;-8
2019;3801 Horten;58 år;6;13;7
2019;3801 Horten;59 år;6;2;-4
2019;3801 Horten;60 år;11;11;0
2019;3801 Horten;61 år;6;19;13
2019;3801 Horten;62 år;8;8;0
2019;3801 Horten;63 år;6;11;5
2019;3801 Horten;64 år;5;9;4
2019;3801 Horten;65 år;5;8;3
2019;3801 Horten;66 år;6;7;1
2019;3801 Horten;67 år;5;8;3
2019;3801 Horten;68 år;5;3;-2
2019;3801 Horten;69 år;2;7;5
2019;3801 Horten;70 år;4;4;0
2020;3801 Horten;0 år;19;27;8
2020;3801 Horten;1 år;7;21;14
2020;3801 Horten;2 år;10;22;12
2020;3801 Horten;3 år;14;21;7
2020;3801 Horten;4 år;9;20;11
2020;3801 Horten;5 år;13;15;2
2020;3801 Horten;6 år;11;13;2
2020;3801 Horten;7 år;10;5;-5
2020;3801 Horten;8 år;6;9;3
2020;3801 Horten;9 år;10;10;0
2020;3801 Horten;10 år;7;9;2
2020;3801 Horten;11 år;8;4;-4
2020;3801 Horten;12 år;9;9;0
2020;3801 Horten;13 år;8;10;2
2020;3801 Horten;14 år;10;6;-4
2020;3801 Horten;15 år;8;13;5
2020;3801 Horten;16 år;15;14;-1
2020;3801 Horten;17 år;8;10;2
2020;3801 Horten;18 år;26;25;-1
2020;3801 Horten;19 år;45;62;17
2020;3801 Horten;20 år;60;67;7
2020;3801 Horten;21 år;81;62;-19
2020;3801 Horten;22 år;55;55;0
2020;3801 Horten;23 år;91;80;-11
2020;3801 Horten;24 år;71;57;-14
2020;3801 Horten;25 år;66;61;-5
2020;3801 Horten;26 år;72;39;-33
2020;3801 Horten;27 år;52;54;2
2020;3801 Horten;28 år;58;45;-13
2020;3801 Horten;29 år;34;37;3
2020;3801 Horten;30 år;29;36;7
2020;3801 Horten;31 år;35;37;2
2020;3801 Horten;32 år;22;28;6
2020;3801 Horten;33 år;18;45;27
2020;3801 Horten;34 år;20;21;1
2020;3801 Horten;35 år;19;25;6
2020;3801 Horten;36 år;13;26;13
2020;3801 Horten;37 år;22;19;-3
2020;3801 Horten;38 år;21;11;-10
2020;3801 Horten;39 år;12;20;8
2020;3801 Horten;40 år;17;21;4
2020;3801 Horten;41 år;11;15;4
2020;3801 Horten;42 år;11;18;7
2020;3801 Horten;43 år;7;18;11
2020;3801 Horten;44 år;8;9;1
2020;3801 Horten;45 år;13;11;-2
2020;3801 Horten;46 år;12;1;-11
2020;3801 Horten;47 år;11;13;2
2020;3801 Horten;48 år;10;19;9
2020;3801 Horten;49 år;14;22;8
2020;3801 Horten;50 år;10;17;7
2020;3801 Horten;51 år;7;13;6
2020;3801 Horten;52 år;12;22;10
2020;3801 Horten;53 år;13;13;0
2020;3801 Horten;54 år;9;17;8
2020;3801 Horten;55 år;6;11;5
2020;3801 Horten;56 år;6;5;-1
2020;3801 Horten;57 år;10;12;2
2020;3801 Horten;58 år;10;11;1
2020;3801 Horten;59 år;6;8;2
2020;3801 Horten;60 år;9;12;3
2020;3801 Horten;61 år;12;11;-1
2020;3801 Horten;62 år;6;9;3
2020;3801 Horten;63 år;8;16;8
2020;3801 Horten;64 år;;10;10
2020;3801 Horten;65 år;4;12;8
2020;3801 Horten;66 år;5;9;4
2020;3801 Horten;67 år;3;14;11
2020;3801 Horten;68 år;6;6;0
2020;3801 Horten;69 år;3;5;2
2020;3801 Horten;70 år;5;5;0
2020;3802 Holmestrand;0 år;13;30;17
2020;3802 Holmestrand;1 år;11;15;4
2020;3802 Holmestrand;2 år;13;18;5
2020;3802 Holmestrand;3 år;11;14;3
2020;3802 Holmestrand;4 år;9;11;2
2020;3802 Holmestrand;5 år;8;12;4
2020;3802 Holmestrand;6 år;10;8;-2
2020;3802 Holmestrand;7 år;6;13;7
2020;3802 Holmestrand;8 år;3;9;6
2020;3802 Holmestrand;9 år;9;12;3
2020;3802 Holmestrand;10 år;10;9;-1
2020;3802 Holmestrand;11 år;5;7;2
2020;3802 Holmestrand;12 år;4;6;2
2020;3802 Holmestrand;13 år;5;11;6
2020;3802 Holmestrand;14 år;4;5;1
2020;3802 Holmestrand;15 år;13;13;0
2020;3802 Holmestrand;16 år;14;12;-2
2020;3802 Holmestrand;17 år;6;9;3
2020;3802 Holmestrand;18 år;27;23;-4
2020;3802 Holmestrand;19 år;32;25;-7
2020;3802 Holmestrand;20 år;51;39;-12
2020;3802 Holmestrand;21 år;51;30;-21
2020;3802 Holmestrand;22 år;49;43;-6
2020;3802 Holmestrand;23 år;52;44;-8
2020;3802 Holmestrand;24 år;46;60;14
2020;3802 Holmestrand;25 år;47;72;25
2020;3802 Holmestrand;26 år;46;57;11
2020;3802 Holmestrand;27 år;50;52;2
2020;3802 Holmestrand;28 år;40;53;13
2020;3802 Holmestrand;29 år;33;48;15
2020;3802 Holmestrand;30 år;31;40;9
2020;3802 Holmestrand;31 år;36;43;7
2020;3802 Holmestrand;32 år;21;35;14
2020;3802 Holmestrand;33 år;19;38;19
2020;3802 Holmestrand;34 år;24;26;2
2020;3802 Holmestrand;35 år;12;23;11
2020;3802 Holmestrand;36 år;15;17;2
2020;3802 Holmestrand;37 år;11;17;6
2020;3802 Holmestrand;38 år;20;31;11
2020;3802 Holmestrand;39 år;12;18;6
2020;3802 Holmestrand;40 år;10;25;15
2020;3802 Holmestrand;41 år;15;18;3
2020;3802 Holmestrand;42 år;22;26;4
2020;3802 Holmestrand;43 år;13;13;0
2020;3802 Holmestrand;44 år;13;13;0
2020;3802 Holmestrand;45 år;15;16;1
2020;3802 Holmestrand;46 år;13;19;6
2020;3802 Holmestrand;47 år;8;13;5
2020;3802 Holmestrand;48 år;13;10;-3
2020;3802 Holmestrand;49 år;13;19;6
2020;3802 Holmestrand;50 år;13;16;3
2020;3802 Holmestrand;51 år;11;19;8
2020;3802 Holmestrand;52 år;16;13;-3
2020;3802 Holmestrand;53 år;11;14;3
2020;3802 Holmestrand;54 år;10;12;2
2020;3802 Holmestrand;55 år;11;11;0
2020;3802 Holmestrand;56 år;8;16;8
2020;3802 Holmestrand;57 år;14;12;-2
2020;3802 Holmestrand;58 år;7;10;3
2020;3802 Holmestrand;59 år;7;11;4
2020;3802 Holmestrand;60 år;9;13;4
2020;3802 Holmestrand;61 år;9;8;-1
2020;3802 Holmestrand;62 år;8;9;1
2020;3802 Holmestrand;63 år;10;9;-1
2020;3802 Holmestrand;64 år;8;13;5
2020;3802 Holmestrand;65 år;1;15;14
2020;3802 Holmestrand;66 år;4;13;9
2020;3802 Holmestrand;67 år;6;9;3
2020;3802 Holmestrand;68 år;6;12;6
2020;3802 Holmestrand;69 år;6;5;-1
2020;3802 Holmestrand;70 år;6;3;-3
2020;3803 Tønsberg;0 år;43;65;22
2020;3803 Tønsberg;1 år;37;48;11
2020;3803 Tønsberg;2 år;31;53;22
2020;3803 Tønsberg;3 år;27;32;5
2020;3803 Tønsberg;4 år;19;33;14
2020;3803 Tønsberg;5 år;36;39;3
2020;3803 Tønsberg;6 år;18;27;9
2020;3803 Tønsberg;7 år;15;26;11
2020;3803 Tønsberg;8 år;20;23;3
2020;3803 Tønsberg;9 år;20;26;6
2020;3803 Tønsberg;10 år;19;18;-1
2020;3803 Tønsberg;11 år;11;15;4
2020;3803 Tønsberg;12 år;11;26;15
2020;3803 Tønsberg;13 år;14;19;5
2020;3803 Tønsberg;14 år;13;13;0
2020;3803 Tønsberg;15 år;27;35;8
2020;3803 Tønsberg;16 år;24;32;8
2020;3803 Tønsberg;17 år;19;30;11
2020;3803 Tønsberg;18 år;52;70;18
2020;3803 Tønsberg;19 år;125;86;-39
2020;3803 Tønsberg;20 år;143;120;-23
2020;3803 Tønsberg;21 år;111;128;17
2020;3803 Tønsberg;22 år;132;116;-16
2020;3803 Tønsberg;23 år;144;160;16
2020;3803 Tønsberg;24 år;155;139;-16
2020;3803 Tønsberg;25 år;141;144;3
2020;3803 Tønsberg;26 år;138;165;27
2020;3803 Tønsberg;27 år;137;145;8
2020;3803 Tønsberg;28 år;120;134;14
2020;3803 Tønsberg;29 år;123;107;-16
2020;3803 Tønsberg;30 år;80;115;35
2020;3803 Tønsberg;31 år;78;103;25
2020;3803 Tønsberg;32 år;68;102;34
2020;3803 Tønsberg;33 år;68;86;18
2020;3803 Tønsberg;34 år;57;60;3
2020;3803 Tønsberg;35 år;52;68;16
2020;3803 Tønsberg;36 år;44;63;19
2020;3803 Tønsberg;37 år;30;57;27
2020;3803 Tønsberg;38 år;48;67;19
2020;3803 Tønsberg;39 år;37;49;12
2020;3803 Tønsberg;40 år;38;43;5
2020;3803 Tønsberg;41 år;30;39;9
2020;3803 Tønsberg;42 år;50;49;-1
2020;3803 Tønsberg;43 år;33;39;6
2020;3803 Tønsberg;44 år;26;30;4
2020;3803 Tønsberg;45 år;28;28;0
2020;3803 Tønsberg;46 år;18;27;9
2020;3803 Tønsberg;47 år;25;41;16
2020;3803 Tønsberg;48 år;31;41;10
2020;3803 Tønsberg;49 år;28;33;5
2020;3803 Tønsberg;50 år;29;39;10
2020;3803 Tønsberg;51 år;33;41;8
2020;3803 Tønsberg;52 år;28;39;11
2020;3803 Tønsberg;53 år;22;43;21
2020;3803 Tønsberg;54 år;38;40;2
2020;3803 Tønsberg;55 år;21;23;2
2020;3803 Tønsberg;56 år;14;28;14
2020;3803 Tønsberg;57 år;22;28;6
2020;3803 Tønsberg;58 år;20;30;10
2020;3803 Tønsberg;59 år;19;36;17
2020;3803 Tønsberg;60 år;27;38;11
2020;3803 Tønsberg;61 år;16;19;3
2020;3803 Tønsberg;62 år;26;26;0
2020;3803 Tønsberg;63 år;14;18;4
2020;3803 Tønsberg;64 år;17;23;6
2020;3803 Tønsberg;65 år;17;14;-3
2020;3803 Tønsberg;66 år;9;19;10
2020;3803 Tønsberg;67 år;11;14;3
2020;3803 Tønsberg;68 år;6;16;10
2020;3803 Tønsberg;69 år;9;18;9
2020;3803 Tønsberg;70 år;13;11;-2
2020;3804 Sandefjord;0 år;25;67;42
2020;3804 Sandefjord;1 år;27;47;20
2020;3804 Sandefjord;2 år;33;47;14
2020;3804 Sandefjord;3 år;27;49;22
2020;3804 Sandefjord;4 år;25;41;16
2020;3804 Sandefjord;5 år;19;29;10
2020;3804 Sandefjord;6 år;25;30;5
2020;3804 Sandefjord;7 år;14;44;30
2020;3804 Sandefjord;8 år;23;31;8
2020;3804 Sandefjord;9 år;14;30;16
2020;3804 Sandefjord;10 år;21;32;11
2020;3804 Sandefjord;11 år;9;26;17
2020;3804 Sandefjord;12 år;17;28;11
2020;3804 Sandefjord;13 år;12;21;9
2020;3804 Sandefjord;14 år;10;25;15
2020;3804 Sandefjord;15 år;20;31;11
2020;3804 Sandefjord;16 år;23;37;14
2020;3804 Sandefjord;17 år;19;36;17
2020;3804 Sandefjord;18 år;68;73;5
2020;3804 Sandefjord;19 år;117;81;-36
2020;3804 Sandefjord;20 år;162;102;-60
2020;3804 Sandefjord;21 år;145;113;-32
2020;3804 Sandefjord;22 år;123;120;-3
2020;3804 Sandefjord;23 år;149;126;-23
2020;3804 Sandefjord;24 år;127;116;-11
2020;3804 Sandefjord;25 år;126;114;-12
2020;3804 Sandefjord;26 år;111;129;18
2020;3804 Sandefjord;27 år;115;96;-19
2020;3804 Sandefjord;28 år;76;128;52
2020;3804 Sandefjord;29 år;73;92;19
2020;3804 Sandefjord;30 år;77;92;15
2020;3804 Sandefjord;31 år;83;85;2
2020;3804 Sandefjord;32 år;46;89;43
2020;3804 Sandefjord;33 år;52;81;29
2020;3804 Sandefjord;34 år;44;69;25
2020;3804 Sandefjord;35 år;53;45;-8
2020;3804 Sandefjord;36 år;51;77;26
2020;3804 Sandefjord;37 år;41;42;1
2020;3804 Sandefjord;38 år;33;62;29
2020;3804 Sandefjord;39 år;32;40;8
2020;3804 Sandefjord;40 år;33;47;14
2020;3804 Sandefjord;41 år;27;30;3
2020;3804 Sandefjord;42 år;22;39;17
2020;3804 Sandefjord;43 år;30;40;10
2020;3804 Sandefjord;44 år;18;40;22
2020;3804 Sandefjord;45 år;27;33;6
2020;3804 Sandefjord;46 år;18;25;7
2020;3804 Sandefjord;47 år;25;40;15
2020;3804 Sandefjord;48 år;30;28;-2
2020;3804 Sandefjord;49 år;37;35;-2
2020;3804 Sandefjord;50 år;31;29;-2
2020;3804 Sandefjord;51 år;22;39;17
2020;3804 Sandefjord;52 år;31;22;-9
2020;3804 Sandefjord;53 år;26;28;2
2020;3804 Sandefjord;54 år;25;30;5
2020;3804 Sandefjord;55 år;17;19;2
2020;3804 Sandefjord;56 år;18;19;1
2020;3804 Sandefjord;57 år;10;18;8
2020;3804 Sandefjord;58 år;18;19;1
2020;3804 Sandefjord;59 år;11;16;5
2020;3804 Sandefjord;60 år;17;24;7
2020;3804 Sandefjord;61 år;17;22;5
2020;3804 Sandefjord;62 år;14;25;11
2020;3804 Sandefjord;63 år;10;10;0
2020;3804 Sandefjord;64 år;9;19;10
2020;3804 Sandefjord;65 år;11;16;5
2020;3804 Sandefjord;66 år;8;12;4
2020;3804 Sandefjord;67 år;17;14;-3
2020;3804 Sandefjord;68 år;7;11;4
2020;3804 Sandefjord;69 år;9;14;5
2020;3804 Sandefjord;70 år;7;14;7
2020;3805 Larvik;0 år;17;43;26
2020;3805 Larvik;1 år;13;33;20
2020;3805 Larvik;2 år;25;37;12
2020;3805 Larvik;3 år;19;34;15
2020;3805 Larvik;4 år;14;22;8
2020;3805 Larvik;5 år;18;27;9
2020;3805 Larvik;6 år;21;19;-2
2020;3805 Larvik;7 år;9;16;7
2020;3805 Larvik;8 år;13;17;4
2020;3805 Larvik;9 år;12;17;5
2020;3805 Larvik;10 år;6;21;15
2020;3805 Larvik;11 år;6;15;9
2020;3805 Larvik;12 år;9;10;1
2020;3805 Larvik;13 år;6;8;2
2020;3805 Larvik;14 år;11;17;6
2020;3805 Larvik;15 år;12;16;4
2020;3805 Larvik;16 år;8;14;6
2020;3805 Larvik;17 år;12;12;0
2020;3805 Larvik;18 år;44;35;-9
2020;3805 Larvik;19 år;81;46;-35
2020;3805 Larvik;20 år;100;59;-41
2020;3805 Larvik;21 år;84;62;-22
2020;3805 Larvik;22 år;72;85;13
2020;3805 Larvik;23 år;107;71;-36
2020;3805 Larvik;24 år;88;74;-14
2020;3805 Larvik;25 år;75;69;-6
2020;3805 Larvik;26 år;73;84;11
2020;3805 Larvik;27 år;69;70;1
2020;3805 Larvik;28 år;63;67;4
2020;3805 Larvik;29 år;39;66;27
2020;3805 Larvik;30 år;32;48;16
2020;3805 Larvik;31 år;39;69;30
2020;3805 Larvik;32 år;47;45;-2
2020;3805 Larvik;33 år;38;42;4
2020;3805 Larvik;34 år;36;42;6
2020;3805 Larvik;35 år;23;38;15
2020;3805 Larvik;36 år;25;33;8
2020;3805 Larvik;37 år;19;34;15
2020;3805 Larvik;38 år;19;26;7
2020;3805 Larvik;39 år;12;26;14
2020;3805 Larvik;40 år;16;35;19
2020;3805 Larvik;41 år;18;30;12
2020;3805 Larvik;42 år;16;22;6
2020;3805 Larvik;43 år;10;17;7
2020;3805 Larvik;44 år;18;20;2
2020;3805 Larvik;45 år;5;14;9
2020;3805 Larvik;46 år;14;21;7
2020;3805 Larvik;47 år;13;16;3
2020;3805 Larvik;48 år;11;12;1
2020;3805 Larvik;49 år;13;14;1
2020;3805 Larvik;50 år;15;18;3
2020;3805 Larvik;51 år;14;21;7
2020;3805 Larvik;52 år;14;23;9
2020;3805 Larvik;53 år;11;21;10
2020;3805 Larvik;54 år;24;16;-8
2020;3805 Larvik;55 år;11;9;-2
2020;3805 Larvik;56 år;12;22;10
2020;3805 Larvik;57 år;8;5;-3
2020;3805 Larvik;58 år;8;10;2
2020;3805 Larvik;59 år;6;16;10
2020;3805 Larvik;60 år;11;14;3
2020;3805 Larvik;61 år;10;11;1
2020;3805 Larvik;62 år;7;13;6
2020;3805 Larvik;63 år;5;12;7
2020;3805 Larvik;64 år;5;13;8
2020;3805 Larvik;65 år;11;12;1
2020;3805 Larvik;66 år;10;14;4
2020;3805 Larvik;67 år;6;13;7
2020;3805 Larvik;68 år;6;13;7
2020;3805 Larvik;69 år;6;11;5
2020;3805 Larvik;70 år;3;15;12
2020;3811 Færder;0 år;25;32;7
2020;3811 Færder;1 år;10;23;13
2020;3811 Færder;2 år;13;29;16
2020;3811 Færder;3 år;11;27;16
2020;3811 Færder;4 år;14;16;2
2020;3811 Færder;5 år;15;22;7
2020;3811 Færder;6 år;8;18;10
2020;3811 Færder;7 år;10;11;1
2020;3811 Færder;8 år;6;13;7
2020;3811 Færder;9 år;10;14;4
2020;3811 Færder;10 år;5;11;6
2020;3811 Færder;11 år;6;9;3
2020;3811 Færder;12 år;8;14;6
2020;3811 Færder;13 år;8;13;5
2020;3811 Færder;14 år;7;16;9
2020;3811 Færder;15 år;18;14;-4
2020;3811 Færder;16 år;12;8;-4
2020;3811 Færder;17 år;15;6;-9
2020;3811 Færder;18 år;24;20;-4
2020;3811 Færder;19 år;51;35;-16
2020;3811 Færder;20 år;84;47;-37
2020;3811 Færder;21 år;64;32;-32
2020;3811 Færder;22 år;71;51;-20
2020;3811 Færder;23 år;71;51;-20
2020;3811 Færder;24 år;79;55;-24
2020;3811 Færder;25 år;62;67;5
2020;3811 Færder;26 år;67;54;-13
2020;3811 Færder;27 år;64;45;-19
2020;3811 Færder;28 år;39;47;8
2020;3811 Færder;29 år;49;71;22
2020;3811 Færder;30 år;42;51;9
2020;3811 Færder;31 år;37;53;16
2020;3811 Færder;32 år;35;35;0
2020;3811 Færder;33 år;36;31;-5
2020;3811 Færder;34 år;19;42;23
2020;3811 Færder;35 år;10;34;24
2020;3811 Færder;36 år;16;33;17
2020;3811 Færder;37 år;15;15;0
2020;3811 Færder;38 år;11;24;13
2020;3811 Færder;39 år;12;24;12
2020;3811 Færder;40 år;9;21;12
2020;3811 Færder;41 år;12;21;9
2020;3811 Færder;42 år;14;23;9
2020;3811 Færder;43 år;20;25;5
2020;3811 Færder;44 år;8;14;6
2020;3811 Færder;45 år;9;16;7
2020;3811 Færder;46 år;7;16;9
2020;3811 Færder;47 år;19;17;-2
2020;3811 Færder;48 år;14;17;3
2020;3811 Færder;49 år;11;13;2
2020;3811 Færder;50 år;15;13;-2
2020;3811 Færder;51 år;19;20;1
2020;3811 Færder;52 år;11;18;7
2020;3811 Færder;53 år;14;16;2
2020;3811 Færder;54 år;19;24;5
2020;3811 Færder;55 år;16;16;0
2020;3811 Færder;56 år;10;20;10
2020;3811 Færder;57 år;17;12;-5
2020;3811 Færder;58 år;15;17;2
2020;3811 Færder;59 år;14;23;9
2020;3811 Færder;60 år;16;14;-2
2020;3811 Færder;61 år;6;20;14
2020;3811 Færder;62 år;14;25;11
2020;3811 Færder;63 år;12;15;3
2020;3811 Færder;64 år;11;16;5
2020;3811 Færder;65 år;8;17;9
2020;3811 Færder;66 år;6;13;7
2020;3811 Færder;67 år;10;27;17
2020;3811 Færder;68 år;12;14;2
2020;3811 Færder;69 år;5;9;4
2020;3811 Færder;70 år;5;14;9
2021;3801 Horten;0 år;17;25;8
2021;3801 Horten;1 år;15;21;6
2021;3801 Horten;2 år;9;16;7
2021;3801 Horten;3 år;6;14;8
2021;3801 Horten;4 år;12;12;0
2021;3801 Horten;5 år;18;13;-5
2021;3801 Horten;6 år;7;9;2
2021;3801 Horten;7 år;7;7;0
2021;3801 Horten;8 år;5;6;1
2021;3801 Horten;9 år;3;5;2
2021;3801 Horten;10 år;10;11;1
2021;3801 Horten;11 år;6;3;-3
2021;3801 Horten;12 år;5;13;8
2021;3801 Horten;13 år;3;12;9
2021;3801 Horten;14 år;7;10;3
2021;3801 Horten;15 år;2;8;6
2021;3801 Horten;16 år;8;12;4
2021;3801 Horten;17 år;6;18;12
2021;3801 Horten;18 år;20;28;8
2021;3801 Horten;19 år;67;49;-18
2021;3801 Horten;20 år;63;69;6
2021;3801 Horten;21 år;87;59;-28
2021;3801 Horten;22 år;72;72;0
2021;3801 Horten;23 år;79;54;-25
2021;3801 Horten;24 år;84;60;-24
2021;3801 Horten;25 år;75;72;-3
2021;3801 Horten;26 år;86;57;-29
2021;3801 Horten;27 år;61;47;-14
2021;3801 Horten;28 år;50;46;-4
2021;3801 Horten;29 år;54;47;-7
2021;3801 Horten;30 år;54;42;-12
2021;3801 Horten;31 år;40;47;7
2021;3801 Horten;32 år;45;33;-12
2021;3801 Horten;33 år;27;34;7
2021;3801 Horten;34 år;25;30;5
2021;3801 Horten;35 år;23;34;11
2021;3801 Horten;36 år;14;24;10
2021;3801 Horten;37 år;18;14;-4
2021;3801 Horten;38 år;11;27;16
2021;3801 Horten;39 år;18;13;-5
2021;3801 Horten;40 år;16;19;3
2021;3801 Horten;41 år;14;11;-3
2021;3801 Horten;42 år;9;16;7
2021;3801 Horten;43 år;12;15;3
2021;3801 Horten;44 år;15;15;0
2021;3801 Horten;45 år;9;11;2
2021;3801 Horten;46 år;8;13;5
2021;3801 Horten;47 år;9;12;3
2021;3801 Horten;48 år;14;11;-3
2021;3801 Horten;49 år;12;14;2
2021;3801 Horten;50 år;7;15;8
2021;3801 Horten;51 år;8;14;6
2021;3801 Horten;52 år;12;8;-4
2021;3801 Horten;53 år;21;16;-5
2021;3801 Horten;54 år;13;16;3
2021;3801 Horten;55 år;11;15;4
2021;3801 Horten;56 år;11;23;12
2021;3801 Horten;57 år;8;18;10
2021;3801 Horten;58 år;9;13;4
2021;3801 Horten;59 år;9;15;6
2021;3801 Horten;60 år;8;10;2
2021;3801 Horten;61 år;7;9;2
2021;3801 Horten;62 år;9;10;1
2021;3801 Horten;63 år;6;10;4
2021;3801 Horten;64 år;8;7;-1
2021;3801 Horten;65 år;4;9;5
2021;3801 Horten;66 år;8;6;-2
2021;3801 Horten;67 år;12;12;0
2021;3801 Horten;68 år;4;4;0
2021;3801 Horten;69 år;5;6;1
2021;3801 Horten;70 år;6;5;-1
2021;3802 Holmestrand;0 år;26;34;8
2021;3802 Holmestrand;1 år;15;25;10
2021;3802 Holmestrand;2 år;13;30;17
2021;3802 Holmestrand;3 år;18;22;4
2021;3802 Holmestrand;4 år;8;25;17
2021;3802 Holmestrand;5 år;16;23;7
2021;3802 Holmestrand;6 år;10;14;4
2021;3802 Holmestrand;7 år;5;17;12
2021;3802 Holmestrand;8 år;7;10;3
2021;3802 Holmestrand;9 år;5;14;9
2021;3802 Holmestrand;10 år;14;15;1
2021;3802 Holmestrand;11 år;6;17;11
2021;3802 Holmestrand;12 år;5;13;8
2021;3802 Holmestrand;13 år;4;13;9
2021;3802 Holmestrand;14 år;5;10;5
2021;3802 Holmestrand;15 år;3;15;12
2021;3802 Holmestrand;16 år;5;16;11
2021;3802 Holmestrand;17 år;10;13;3
2021;3802 Holmestrand;18 år;25;20;-5
2021;3802 Holmestrand;19 år;38;34;-4
2021;3802 Holmestrand;20 år;49;36;-13
2021;3802 Holmestrand;21 år;50;38;-12
2021;3802 Holmestrand;22 år;60;51;-9
2021;3802 Holmestrand;23 år;48;65;17
2021;3802 Holmestrand;24 år;49;65;16
2021;3802 Holmestrand;25 år;65;71;6
2021;3802 Holmestrand;26 år;60;75;15
2021;3802 Holmestrand;27 år;29;60;31
2021;3802 Holmestrand;28 år;36;58;22
2021;3802 Holmestrand;29 år;32;55;23
2021;3802 Holmestrand;30 år;39;56;17
2021;3802 Holmestrand;31 år;24;56;32
2021;3802 Holmestrand;32 år;25;57;32
2021;3802 Holmestrand;33 år;19;49;30
2021;3802 Holmestrand;34 år;30;34;4
2021;3802 Holmestrand;35 år;27;31;4
2021;3802 Holmestrand;36 år;28;30;2
2021;3802 Holmestrand;37 år;20;33;13
2021;3802 Holmestrand;38 år;22;32;10
2021;3802 Holmestrand;39 år;20;31;11
2021;3802 Holmestrand;40 år;14;28;14
2021;3802 Holmestrand;41 år;16;17;1
2021;3802 Holmestrand;42 år;12;18;6
2021;3802 Holmestrand;43 år;13;28;15
2021;3802 Holmestrand;44 år;8;22;14
2021;3802 Holmestrand;45 år;19;22;3
2021;3802 Holmestrand;46 år;11;26;15
2021;3802 Holmestrand;47 år;19;19;0
2021;3802 Holmestrand;48 år;9;24;15
2021;3802 Holmestrand;49 år;18;16;-2
2021;3802 Holmestrand;50 år;12;26;14
2021;3802 Holmestrand;51 år;11;23;12
2021;3802 Holmestrand;52 år;10;19;9
2021;3802 Holmestrand;53 år;13;28;15
2021;3802 Holmestrand;54 år;17;22;5
2021;3802 Holmestrand;55 år;21;23;2
2021;3802 Holmestrand;56 år;12;24;12
2021;3802 Holmestrand;57 år;13;18;5
2021;3802 Holmestrand;58 år;13;17;4
2021;3802 Holmestrand;59 år;10;16;6
2021;3802 Holmestrand;60 år;10;13;3
2021;3802 Holmestrand;61 år;4;14;10
2021;3802 Holmestrand;62 år;6;22;16
2021;3802 Holmestrand;63 år;9;17;8
2021;3802 Holmestrand;64 år;7;14;7
2021;3802 Holmestrand;65 år;7;7;0
2021;3802 Holmestrand;66 år;4;17;13
2021;3802 Holmestrand;67 år;6;15;9
2021;3802 Holmestrand;68 år;11;18;7
2021;3802 Holmestrand;69 år;7;6;-1
2021;3802 Holmestrand;70 år;5;9;4
2021;3803 Tønsberg;0 år;56;69;13
2021;3803 Tønsberg;1 år;34;53;19
2021;3803 Tønsberg;2 år;30;45;15
2021;3803 Tønsberg;3 år;38;48;10
2021;3803 Tønsberg;4 år;24;45;21
2021;3803 Tønsberg;5 år;26;45;19
2021;3803 Tønsberg;6 år;15;27;12
2021;3803 Tønsberg;7 år;18;16;-2
2021;3803 Tønsberg;8 år;19;28;9
2021;3803 Tønsberg;9 år;22;17;-5
2021;3803 Tønsberg;10 år;16;21;5
2021;3803 Tønsberg;11 år;18;15;-3
2021;3803 Tønsberg;12 år;15;18;3
2021;3803 Tønsberg;13 år;12;19;7
2021;3803 Tønsberg;14 år;13;13;0
2021;3803 Tønsberg;15 år;20;25;5
2021;3803 Tønsberg;16 år;18;37;19
2021;3803 Tønsberg;17 år;24;24;0
2021;3803 Tønsberg;18 år;55;79;24
2021;3803 Tønsberg;19 år;103;97;-6
2021;3803 Tønsberg;20 år;124;135;11
2021;3803 Tønsberg;21 år;149;142;-7
2021;3803 Tønsberg;22 år;126;147;21
2021;3803 Tønsberg;23 år;145;160;15
2021;3803 Tønsberg;24 år;140;161;21
2021;3803 Tønsberg;25 år;177;154;-23
2021;3803 Tønsberg;26 år;162;158;-4
2021;3803 Tønsberg;27 år;154;155;1
2021;3803 Tønsberg;28 år;119;149;30
2021;3803 Tønsberg;29 år;107;149;42
2021;3803 Tønsberg;30 år;121;118;-3
2021;3803 Tønsberg;31 år;84;91;7
2021;3803 Tønsberg;32 år;87;111;24
2021;3803 Tønsberg;33 år;65;104;39
2021;3803 Tønsberg;34 år;54;88;34
2021;3803 Tønsberg;35 år;63;95;32
2021;3803 Tønsberg;36 år;61;69;8
2021;3803 Tønsberg;37 år;51;56;5
2021;3803 Tønsberg;38 år;40;40;0
2021;3803 Tønsberg;39 år;42;58;16
2021;3803 Tønsberg;40 år;37;47;10
2021;3803 Tønsberg;41 år;30;46;16
2021;3803 Tønsberg;42 år;30;45;15
2021;3803 Tønsberg;43 år;46;48;2
2021;3803 Tønsberg;44 år;24;36;12
2021;3803 Tønsberg;45 år;28;38;10
2021;3803 Tønsberg;46 år;34;35;1
2021;3803 Tønsberg;47 år;26;33;7
2021;3803 Tønsberg;48 år;33;40;7
2021;3803 Tønsberg;49 år;24;23;-1
2021;3803 Tønsberg;50 år;31;30;-1
2021;3803 Tønsberg;51 år;23;37;14
2021;3803 Tønsberg;52 år;28;49;21
2021;3803 Tønsberg;53 år;34;42;8
2021;3803 Tønsberg;54 år;27;41;14
2021;3803 Tønsberg;55 år;36;45;9
2021;3803 Tønsberg;56 år;34;23;-11
2021;3803 Tønsberg;57 år;19;24;5
2021;3803 Tønsberg;58 år;21;34;13
2021;3803 Tønsberg;59 år;23;27;4
2021;3803 Tønsberg;60 år;16;22;6
2021;3803 Tønsberg;61 år;23;21;-2
2021;3803 Tønsberg;62 år;14;27;13
2021;3803 Tønsberg;63 år;25;22;-3
2021;3803 Tønsberg;64 år;21;23;2
2021;3803 Tønsberg;65 år;19;23;4
2021;3803 Tønsberg;66 år;15;23;8
2021;3803 Tønsberg;67 år;12;21;9
2021;3803 Tønsberg;68 år;7;16;9
2021;3803 Tønsberg;69 år;18;14;-4
2021;3803 Tønsberg;70 år;14;17;3
2021;3804 Sandefjord;0 år;35;65;30
2021;3804 Sandefjord;1 år;22;63;41
2021;3804 Sandefjord;2 år;25;58;33
2021;3804 Sandefjord;3 år;25;47;22
2021;3804 Sandefjord;4 år;26;40;14
2021;3804 Sandefjord;5 år;24;42;18
2021;3804 Sandefjord;6 år;23;34;11
2021;3804 Sandefjord;7 år;21;25;4
2021;3804 Sandefjord;8 år;22;23;1
2021;3804 Sandefjord;9 år;23;32;9
2021;3804 Sandefjord;10 år;21;23;2
2021;3804 Sandefjord;11 år;16;32;16
2021;3804 Sandefjord;12 år;14;22;8
2021;3804 Sandefjord;13 år;21;21;0
2021;3804 Sandefjord;14 år;12;27;15
2021;3804 Sandefjord;15 år;16;24;8
2021;3804 Sandefjord;16 år;24;39;15
2021;3804 Sandefjord;17 år;22;19;-3
2021;3804 Sandefjord;18 år;67;53;-14
2021;3804 Sandefjord;19 år;113;69;-44
2021;3804 Sandefjord;20 år;147;87;-60
2021;3804 Sandefjord;21 år;132;104;-28
2021;3804 Sandefjord;22 år;140;99;-41
2021;3804 Sandefjord;23 år;132;105;-27
2021;3804 Sandefjord;24 år;145;131;-14
2021;3804 Sandefjord;25 år;125;153;28
2021;3804 Sandefjord;26 år;120;140;20
2021;3804 Sandefjord;27 år;119;120;1
2021;3804 Sandefjord;28 år;94;124;30
2021;3804 Sandefjord;29 år;86;116;30
2021;3804 Sandefjord;30 år;84;98;14
2021;3804 Sandefjord;31 år;60;96;36
2021;3804 Sandefjord;32 år;68;95;27
2021;3804 Sandefjord;33 år;58;59;1
2021;3804 Sandefjord;34 år;56;77;21
2021;3804 Sandefjord;35 år;41;70;29
2021;3804 Sandefjord;36 år;49;69;20
2021;3804 Sandefjord;37 år;38;56;18
2021;3804 Sandefjord;38 år;29;61;32
2021;3804 Sandefjord;39 år;36;39;3
2021;3804 Sandefjord;40 år;36;49;13
2021;3804 Sandefjord;41 år;29;46;17
2021;3804 Sandefjord;42 år;26;42;16
2021;3804 Sandefjord;43 år;33;41;8
2021;3804 Sandefjord;44 år;28;33;5
2021;3804 Sandefjord;45 år;30;33;3
2021;3804 Sandefjord;46 år;23;29;6
2021;3804 Sandefjord;47 år;28;43;15
2021;3804 Sandefjord;48 år;29;30;1
2021;3804 Sandefjord;49 år;23;44;21
2021;3804 Sandefjord;50 år;25;35;10
2021;3804 Sandefjord;51 år;23;41;18
2021;3804 Sandefjord;52 år;28;32;4
2021;3804 Sandefjord;53 år;31;36;5
2021;3804 Sandefjord;54 år;25;31;6
2021;3804 Sandefjord;55 år;18;24;6
2021;3804 Sandefjord;56 år;19;36;17
2021;3804 Sandefjord;57 år;23;25;2
2021;3804 Sandefjord;58 år;31;18;-13
2021;3804 Sandefjord;59 år;18;14;-4
2021;3804 Sandefjord;60 år;18;23;5
2021;3804 Sandefjord;61 år;14;20;6
2021;3804 Sandefjord;62 år;20;22;2
2021;3804 Sandefjord;63 år;18;17;-1
2021;3804 Sandefjord;64 år;9;18;9
2021;3804 Sandefjord;65 år;14;10;-4
2021;3804 Sandefjord;66 år;17;18;1
2021;3804 Sandefjord;67 år;10;16;6
2021;3804 Sandefjord;68 år;7;14;7
2021;3804 Sandefjord;69 år;4;12;8
2021;3804 Sandefjord;70 år;9;17;8
2021;3805 Larvik;0 år;20;39;19
2021;3805 Larvik;1 år;19;28;9
2021;3805 Larvik;2 år;21;28;7
2021;3805 Larvik;3 år;15;32;17
2021;3805 Larvik;4 år;19;22;3
2021;3805 Larvik;5 år;18;24;6
2021;3805 Larvik;6 år;17;19;2
2021;3805 Larvik;7 år;11;15;4
2021;3805 Larvik;8 år;11;17;6
2021;3805 Larvik;9 år;8;17;9
2021;3805 Larvik;10 år;6;15;9
2021;3805 Larvik;11 år;8;14;6
2021;3805 Larvik;12 år;6;16;10
2021;3805 Larvik;13 år;18;15;-3
2021;3805 Larvik;14 år;13;11;-2
2021;3805 Larvik;15 år;9;15;6
2021;3805 Larvik;16 år;7;24;17
2021;3805 Larvik;17 år;11;18;7
2021;3805 Larvik;18 år;32;29;-3
2021;3805 Larvik;19 år;58;46;-12
2021;3805 Larvik;20 år;91;62;-29
2021;3805 Larvik;21 år;91;70;-21
2021;3805 Larvik;22 år;90;66;-24
2021;3805 Larvik;23 år;103;84;-19
2021;3805 Larvik;24 år;93;83;-10
2021;3805 Larvik;25 år;96;80;-16
2021;3805 Larvik;26 år;104;79;-25
2021;3805 Larvik;27 år;60;70;10
2021;3805 Larvik;28 år;53;64;11
2021;3805 Larvik;29 år;52;70;18
2021;3805 Larvik;30 år;64;81;17
2021;3805 Larvik;31 år;42;57;15
2021;3805 Larvik;32 år;36;50;14
2021;3805 Larvik;33 år;24;48;24
2021;3805 Larvik;34 år;32;49;17
2021;3805 Larvik;35 år;34;39;5
2021;3805 Larvik;36 år;26;37;11
2021;3805 Larvik;37 år;11;36;25
2021;3805 Larvik;38 år;14;27;13
2021;3805 Larvik;39 år;21;40;19
2021;3805 Larvik;40 år;5;31;26
2021;3805 Larvik;41 år;11;17;6
2021;3805 Larvik;42 år;26;19;-7
2021;3805 Larvik;43 år;14;22;8
2021;3805 Larvik;44 år;17;25;8
2021;3805 Larvik;45 år;11;17;6
2021;3805 Larvik;46 år;9;16;7
2021;3805 Larvik;47 år;14;16;2
2021;3805 Larvik;48 år;9;21;12
2021;3805 Larvik;49 år;15;18;3
2021;3805 Larvik;50 år;15;19;4
2021;3805 Larvik;51 år;23;16;-7
2021;3805 Larvik;52 år;12;18;6
2021;3805 Larvik;53 år;16;21;5
2021;3805 Larvik;54 år;14;19;5
2021;3805 Larvik;55 år;13;15;2
2021;3805 Larvik;56 år;8;18;10
2021;3805 Larvik;57 år;14;17;3
2021;3805 Larvik;58 år;12;21;9
2021;3805 Larvik;59 år;9;15;6
2021;3805 Larvik;60 år;14;18;4
2021;3805 Larvik;61 år;15;15;0
2021;3805 Larvik;62 år;8;26;18
2021;3805 Larvik;63 år;9;12;3
2021;3805 Larvik;64 år;11;10;-1
2021;3805 Larvik;65 år;12;11;-1
2021;3805 Larvik;66 år;6;15;9
2021;3805 Larvik;67 år;12;7;-5
2021;3805 Larvik;68 år;12;9;-3
2021;3805 Larvik;69 år;7;12;5
2021;3805 Larvik;70 år;9;10;1
2021;3811 Færder;0 år;19;43;24
2021;3811 Færder;1 år;13;27;14
2021;3811 Færder;2 år;10;19;9
2021;3811 Færder;3 år;16;19;3
2021;3811 Færder;4 år;9;12;3
2021;3811 Færder;5 år;14;14;0
2021;3811 Færder;6 år;10;18;8
2021;3811 Færder;7 år;6;14;8
2021;3811 Færder;8 år;9;7;-2
2021;3811 Færder;9 år;6;10;4
2021;3811 Færder;10 år;8;12;4
2021;3811 Færder;11 år;10;20;10
2021;3811 Færder;12 år;11;10;-1
2021;3811 Færder;13 år;6;15;9
2021;3811 Færder;14 år;9;7;-2
2021;3811 Færder;15 år;13;7;-6
2021;3811 Færder;16 år;15;12;-3
2021;3811 Færder;17 år;9;18;9
2021;3811 Færder;18 år;27;22;-5
2021;3811 Færder;19 år;52;30;-22
2021;3811 Færder;20 år;57;45;-12
2021;3811 Færder;21 år;77;52;-25
2021;3811 Færder;22 år;62;44;-18
2021;3811 Færder;23 år;71;50;-21
2021;3811 Færder;24 år;87;55;-32
2021;3811 Færder;25 år;71;58;-13
2021;3811 Færder;26 år;73;59;-14
2021;3811 Færder;27 år;62;70;8
2021;3811 Færder;28 år;57;55;-2
2021;3811 Færder;29 år;67;59;-8
2021;3811 Færder;30 år;35;53;18
2021;3811 Færder;31 år;31;51;20
2021;3811 Færder;32 år;35;60;25
2021;3811 Færder;33 år;22;47;25
2021;3811 Færder;34 år;23;34;11
2021;3811 Færder;35 år;24;37;13
2021;3811 Færder;36 år;23;26;3
2021;3811 Færder;37 år;13;25;12
2021;3811 Færder;38 år;17;16;-1
2021;3811 Færder;39 år;18;25;7
2021;3811 Færder;40 år;17;30;13
2021;3811 Færder;41 år;12;25;13
2021;3811 Færder;42 år;21;29;8
2021;3811 Færder;43 år;14;14;0
2021;3811 Færder;44 år;14;19;5
2021;3811 Færder;45 år;12;12;0
2021;3811 Færder;46 år;16;12;-4
2021;3811 Færder;47 år;15;12;-3
2021;3811 Færder;48 år;9;18;9
2021;3811 Færder;49 år;10;25;15
2021;3811 Færder;50 år;15;18;3
2021;3811 Færder;51 år;12;18;6
2021;3811 Færder;52 år;10;18;8
2021;3811 Færder;53 år;7;18;11
2021;3811 Færder;54 år;11;17;6
2021;3811 Færder;55 år;12;16;4
2021;3811 Færder;56 år;15;20;5
2021;3811 Færder;57 år;15;15;0
2021;3811 Færder;58 år;16;19;3
2021;3811 Færder;59 år;13;16;3
2021;3811 Færder;60 år;7;11;4
2021;3811 Færder;61 år;15;13;-2
2021;3811 Færder;62 år;6;16;10
2021;3811 Færder;63 år;9;11;2
2021;3811 Færder;64 år;7;14;7
2021;3811 Færder;65 år;6;15;9
2021;3811 Færder;66 år;12;13;1
2021;3811 Færder;67 år;14;8;-6
2021;3811 Færder;68 år;4;14;10
2021;3811 Færder;69 år;6;14;8
2021;3811 Færder;70 år;8;12;4
